dteday,hr,instant,casual,registered,cnt,interpolated
2011-01-01,0,1,3,13,16,False
2011-01-01,1,2,8,32,40,False
2011-01-01,2,3,5,27,32,False
2011-01-01,3,4,3,10,13,False
2011-01-01,4,5,0,1,1,False
2011-01-01,5,6,0,1,1,False
2011-01-01,6,7,2,0,2,False
2011-01-01,7,8,1,2,3,False
2011-01-01,8,9,1,7,8,False
2011-01-01,9,10,8,6,14,False
2011-01-01,10,11,12,24,36,False
2011-01-01,11,12,26,30,56,False
2011-01-01,12,13,29,55,84,False
2011-01-01,13,14,47,47,94,False
2011-01-01,14,15,35,71,106,False
2011-01-01,15,16,40,70,110,False
2011-01-01,16,17,41,52,93,False
2011-01-01,17,18,15,52,67,False
2011-01-01,18,19,9,26,35,False
2011-01-01,19,20,6,31,37,False
2011-01-01,20,21,11,25,36,False
2011-01-01,21,22,3,31,34,False
2011-01-01,22,23,11,17,28,False
2011-01-01,23,24,15,24,39,False
2011-01-02,0,25,4,13,17,False
2011-01-02,1,26,1,16,17,False
2011-01-02,2,27,1,8,9,False
2011-01-02,3,28,2,4,6,False
2011-01-02,4,29,2,1,3,False
2011-01-02,5,30,1,18,19,True
2011-01-02,6,31,0,2,2,False
2011-01-02,7,32,0,1,1,False
2011-01-02,8,33,0,8,8,False
2011-01-02,9,34,1,19,20,False
2011-01-02,10,35,7,46,53,False
2011-01-02,11,36,16,54,70,False
2011-01-02,12,37,20,73,93,False
2011-01-02,13,38,11,64,75,False
2011-01-02,14,39,4,55,59,False
2011-01-02,15,40,19,55,74,False
2011-01-02,16,41,9,67,76,False
2011-01-02,17,42,7,58,65,False
2011-01-02,18,43,10,43,53,False
2011-01-02,19,44,1,29,30,False
2011-01-02,20,45,5,17,22,False
2011-01-02,21,46,11,20,31,False
2011-01-02,22,47,0,9,9,False
2011-01-02,23,48,0,8,8,False
2011-01-03,0,49,0,5,5,False
2011-01-03,1,50,0,2,2,False
2011-01-03,2,51,5,18,23,True
2011-01-03,3,52,3,9,12,True
2011-01-03,4,53,0,1,1,False
2011-01-03,5,54,0,3,3,False
2011-01-03,6,55,0,30,30,False
2011-01-03,7,56,1,63,64,False
2011-01-03,8,57,1,153,154,False
2011-01-03,9,58,7,81,88,False
2011-01-03,10,59,11,33,44,False
2011-01-03,11,60,10,41,51,False
2011-01-03,12,61,13,48,61,False
2011-01-03,13,62,8,53,61,False
2011-01-03,14,63,11,66,77,False
2011-01-03,15,64,14,58,72,False
2011-01-03,16,65,9,67,76,False
2011-01-03,17,66,11,146,157,False
2011-01-03,18,67,9,148,157,False
2011-01-03,19,68,8,102,110,False
2011-01-03,20,69,3,49,52,False
2011-01-03,21,70,3,49,52,False
2011-01-03,22,71,0,20,20,False
2011-01-03,23,72,1,11,12,False
2011-01-04,0,73,0,5,5,False
2011-01-04,1,74,0,2,2,False
2011-01-04,2,75,0,1,1,False
2011-01-04,3,76,3,9,12,True
2011-01-04,4,77,0,2,2,False
2011-01-04,5,78,0,4,4,False
2011-01-04,6,79,0,36,36,False
2011-01-04,7,80,2,92,94,False
2011-01-04,8,81,2,177,179,False
2011-01-04,9,82,2,98,100,False
2011-01-04,10,83,5,37,42,False
2011-01-04,11,84,7,50,57,False
2011-01-04,12,85,12,66,78,False
2011-01-04,13,86,18,79,97,False
2011-01-04,14,87,9,54,63,False
2011-01-04,15,88,17,48,65,False
2011-01-04,16,89,15,68,83,False
2011-01-04,17,90,10,202,212,False
2011-01-04,18,91,3,179,182,False
2011-01-04,19,92,2,110,112,False
2011-01-04,20,93,1,53,54,False
2011-01-04,21,94,0,48,48,False
2011-01-04,22,95,1,34,35,False
2011-01-04,23,96,2,9,11,False
2011-01-05,0,97,0,6,6,False
2011-01-05,1,98,0,6,6,False
2011-01-05,2,99,0,2,2,False
2011-01-05,3,100,3,9,12,True
2011-01-05,4,101,0,2,2,False
2011-01-05,5,102,0,3,3,False
2011-01-05,6,103,0,33,33,False
2011-01-05,7,104,1,87,88,False
2011-01-05,8,105,3,192,195,False
2011-01-05,9,106,6,109,115,False
2011-01-05,10,107,4,53,57,False
2011-01-05,11,108,12,34,46,False
2011-01-05,12,109,5,74,79,False
2011-01-05,13,110,6,65,71,False
2011-01-05,14,111,10,52,62,False
2011-01-05,15,112,7,55,62,False
2011-01-05,16,113,4,85,89,False
2011-01-05,17,114,4,186,190,False
2011-01-05,18,115,3,166,169,False
2011-01-05,19,116,5,127,132,False
2011-01-05,20,117,7,82,89,False
2011-01-05,21,118,3,40,43,False
2011-01-05,22,119,1,41,42,False
2011-01-05,23,120,1,18,19,False
2011-01-06,0,121,0,11,11,False
2011-01-06,1,122,0,4,4,False
2011-01-06,2,123,0,2,2,False
2011-01-06,3,124,3,9,12,True
2011-01-06,4,125,0,1,1,False
2011-01-06,5,126,0,4,4,False
2011-01-06,6,127,0,36,36,False
2011-01-06,7,128,0,95,95,False
2011-01-06,8,129,3,216,219,False
2011-01-06,9,130,6,116,122,False
2011-01-06,10,131,3,42,45,False
2011-01-06,11,132,2,57,59,False
2011-01-06,12,133,6,78,84,False
2011-01-06,13,134,12,55,67,False
2011-01-06,14,135,11,59,70,False
2011-01-06,15,136,8,54,62,False
2011-01-06,16,137,12,74,86,False
2011-01-06,17,138,9,163,172,False
2011-01-06,18,139,5,158,163,False
2011-01-06,19,140,3,109,112,False
2011-01-06,20,141,3,66,69,False
2011-01-06,21,142,0,48,48,False
2011-01-06,22,143,1,51,52,False
2011-01-06,23,144,4,19,23,False
2011-01-07,0,145,4,13,17,False
2011-01-07,1,146,2,5,7,False
2011-01-07,2,147,0,1,1,False
2011-01-07,3,148,3,9,12,True
2011-01-07,4,149,0,1,1,False
2011-01-07,5,150,0,5,5,False
2011-01-07,6,151,8,26,34,False
2011-01-07,7,152,8,76,84,False
2011-01-07,8,153,20,190,210,False
2011-01-07,9,154,9,125,134,False
2011-01-07,10,155,16,47,63,False
2011-01-07,11,156,19,48,67,False
2011-01-07,12,157,9,50,59,False
2011-01-07,13,158,9,64,73,False
2011-01-07,14,159,7,43,50,False
2011-01-07,15,160,9,63,72,False
2011-01-07,16,161,5,82,87,False
2011-01-07,17,162,9,178,187,False
2011-01-07,18,163,7,116,123,False
2011-01-07,19,164,3,92,95,False
2011-01-07,20,165,1,50,51,False
2011-01-07,21,166,0,39,39,False
2011-01-07,22,167,2,34,36,False
2011-01-07,23,168,1,14,15,False
2011-01-08,0,169,1,24,25,False
2011-01-08,1,170,1,15,16,False
2011-01-08,2,171,3,13,16,False
2011-01-08,3,172,0,7,7,False
2011-01-08,4,173,0,1,1,False
2011-01-08,5,174,0,5,5,False
2011-01-08,6,175,0,2,2,False
2011-01-08,7,176,1,8,9,False
2011-01-08,8,177,0,15,15,False
2011-01-08,9,178,0,20,20,False
2011-01-08,10,179,5,56,61,False
2011-01-08,11,180,2,60,62,False
2011-01-08,12,181,8,90,98,False
2011-01-08,13,182,7,95,102,False
2011-01-08,14,183,12,83,95,False
2011-01-08,15,184,5,69,74,False
2011-01-08,16,185,8,68,76,False
2011-01-08,17,186,5,64,69,False
2011-01-08,18,187,3,52,55,False
2011-01-08,19,188,4,26,30,False
2011-01-08,20,189,0,28,28,False
2011-01-08,21,190,2,35,37,False
2011-01-08,22,191,1,33,34,False
2011-01-08,23,192,0,22,22,False
2011-01-09,0,193,1,24,25,False
2011-01-09,1,194,0,12,12,False
2011-01-09,2,195,0,11,11,False
2011-01-09,3,196,0,4,4,False
2011-01-09,4,197,0,1,1,False
2011-01-09,5,198,0,1,1,False
2011-01-09,6,199,0,1,1,False
2011-01-09,7,200,1,5,6,False
2011-01-09,8,201,0,10,10,False
2011-01-09,9,202,0,19,19,False
2011-01-09,10,203,0,49,49,False
2011-01-09,11,204,2,47,49,False
2011-01-09,12,205,4,79,83,False
2011-01-09,13,206,6,69,75,False
2011-01-09,14,207,8,64,72,False
2011-01-09,15,208,5,77,82,False
2011-01-09,16,209,13,79,92,False
2011-01-09,17,210,3,59,62,False
2011-01-09,18,211,4,44,48,False
2011-01-09,19,212,1,40,41,False
2011-01-09,20,213,0,38,38,False
2011-01-09,21,214,1,19,20,False
2011-01-09,22,215,5,10,15,False
2011-01-09,23,216,0,6,6,False
2011-01-10,0,217,2,3,5,False
2011-01-10,1,218,1,0,1,False
2011-01-10,2,219,0,3,3,False
2011-01-10,3,220,0,1,1,False
2011-01-10,4,221,1,2,3,False
2011-01-10,5,222,0,3,3,False
2011-01-10,6,223,0,31,31,False
2011-01-10,7,224,2,75,77,False
2011-01-10,8,225,4,184,188,False
2011-01-10,9,226,2,92,94,False
2011-01-10,10,227,0,31,31,False
2011-01-10,11,228,2,28,30,False
2011-01-10,12,229,5,47,52,False
2011-01-10,13,230,4,50,54,False
2011-01-10,14,231,0,47,47,False
2011-01-10,15,232,2,43,45,False
2011-01-10,16,233,4,70,74,False
2011-01-10,17,234,4,174,178,False
2011-01-10,18,235,1,154,155,False
2011-01-10,19,236,3,92,95,False
2011-01-10,20,237,1,73,74,False
2011-01-10,21,238,1,37,38,False
2011-01-10,22,239,2,22,24,False
2011-01-10,23,240,0,18,18,False
2011-01-11,0,241,2,10,12,False
2011-01-11,1,242,0,3,3,False
2011-01-11,2,243,0,3,3,False
2011-01-11,3,244,3,9,12,True
2011-01-11,4,245,1,5,6,True
2011-01-11,5,246,0,6,6,False
2011-01-11,6,247,0,27,27,False
2011-01-11,7,248,2,97,99,False
2011-01-11,8,249,3,214,217,False
2011-01-11,9,250,3,127,130,False
2011-01-11,10,251,3,51,54,False
2011-01-11,11,252,4,31,35,False
2011-01-11,12,253,2,55,57,False
2011-01-11,13,254,6,46,52,False
2011-01-11,14,255,3,60,63,False
2011-01-11,15,256,2,45,47,False
2011-01-11,16,257,4,72,76,False
2011-01-11,17,258,6,130,136,False
2011-01-11,18,259,1,94,95,False
2011-01-11,19,260,0,51,51,False
2011-01-11,20,261,0,32,32,False
2011-01-11,21,262,0,20,20,False
2011-01-11,22,263,1,28,29,False
2011-01-11,23,264,1,18,19,False
2011-01-12,0,265,0,7,7,False
2011-01-12,1,266,0,6,6,False
2011-01-12,2,267,0,1,1,False
2011-01-12,3,268,3,9,12,True
2011-01-12,4,269,1,5,6,True
2011-01-12,5,270,0,5,5,False
2011-01-12,6,271,0,16,16,False
2011-01-12,7,272,0,54,54,False
2011-01-12,8,273,3,125,128,False
2011-01-12,9,274,3,78,81,False
2011-01-12,10,275,0,39,39,False
2011-01-12,11,276,3,32,35,False
2011-01-12,12,277,3,52,55,False
2011-01-12,13,278,0,49,49,False
2011-01-12,14,279,0,44,44,False
2011-01-12,15,280,1,48,49,False
2011-01-12,16,281,5,63,68,False
2011-01-12,17,282,0,139,139,False
2011-01-12,18,283,2,135,137,False
2011-01-12,19,284,1,82,83,False
2011-01-12,20,285,2,54,56,False
2011-01-12,21,286,0,57,57,False
2011-01-12,22,287,1,32,33,False
2011-01-12,23,288,1,19,20,False
2011-01-13,0,289,1,6,7,False
2011-01-13,1,290,0,2,2,False
2011-01-13,2,291,0,2,2,False
2011-01-13,3,292,0,3,3,False
2011-01-13,4,293,0,4,4,False
2011-01-13,5,294,0,3,3,False
2011-01-13,6,295,0,28,28,False
2011-01-13,7,296,0,72,72,False
2011-01-13,8,297,5,197,202,False
2011-01-13,9,298,2,137,139,False
2011-01-13,10,299,2,36,38,False
2011-01-13,11,300,4,33,37,False
2011-01-13,12,301,3,49,52,False
2011-01-13,13,302,2,81,83,False
2011-01-13,14,303,3,39,42,False
2011-01-13,15,304,5,55,60,False
2011-01-13,16,305,2,76,78,False
2011-01-13,17,306,4,158,162,False
2011-01-13,18,307,3,141,144,False
2011-01-13,19,308,1,98,99,False
2011-01-13,20,309,0,64,64,False
2011-01-13,21,310,0,40,40,False
2011-01-13,22,311,0,30,30,False
2011-01-13,23,312,1,14,15,False
2011-01-14,0,313,0,14,14,False
2011-01-14,1,314,0,5,5,False
2011-01-14,2,315,0,1,1,False
2011-01-14,3,316,0,1,1,False
2011-01-14,4,317,1,5,6,True
2011-01-14,5,318,0,8,8,False
2011-01-14,6,319,0,17,17,False
2011-01-14,7,320,0,70,70,False
2011-01-14,8,321,2,156,158,False
2011-01-14,9,322,0,117,117,False
2011-01-14,10,323,4,40,44,False
2011-01-14,11,324,6,47,53,False
2011-01-14,12,325,2,59,61,False
2011-01-14,13,326,4,73,77,False
2011-01-14,14,327,5,59,64,False
2011-01-14,15,328,9,59,68,False
2011-01-14,16,329,3,87,90,False
2011-01-14,17,330,4,155,159,False
2011-01-14,18,331,5,134,139,False
2011-01-14,19,332,3,89,92,False
2011-01-14,20,333,0,68,68,False
2011-01-14,21,334,4,48,52,False
2011-01-14,22,335,2,34,36,False
2011-01-14,23,336,1,26,27,False
2011-01-15,0,337,3,25,28,False
2011-01-15,1,338,2,18,20,False
2011-01-15,2,339,0,12,12,False
2011-01-15,3,340,1,7,8,False
2011-01-15,4,341,0,5,5,False
2011-01-15,5,342,0,1,1,False
2011-01-15,6,343,1,2,3,False
2011-01-15,7,344,1,9,10,False
2011-01-15,8,345,1,22,23,False
2011-01-15,9,346,2,31,33,False
2011-01-15,10,347,2,57,59,False
2011-01-15,11,348,18,54,72,False
2011-01-15,12,349,15,74,89,False
2011-01-15,13,350,21,80,101,False
2011-01-15,14,351,26,92,118,False
2011-01-15,15,352,21,108,129,False
2011-01-15,16,353,33,95,128,False
2011-01-15,17,354,29,54,83,False
2011-01-15,18,355,15,69,84,False
2011-01-15,19,356,14,60,74,False
2011-01-15,20,357,6,35,41,False
2011-01-15,21,358,6,51,57,False
2011-01-15,22,359,0,26,26,False
2011-01-15,23,360,5,39,44,False
2011-01-16,0,361,6,33,39,False
2011-01-16,1,362,4,19,23,False
2011-01-16,2,363,3,13,16,False
2011-01-16,3,364,9,6,15,False
2011-01-16,4,365,0,1,1,False
2011-01-16,5,366,1,1,2,False
2011-01-16,6,367,0,1,1,False
2011-01-16,7,368,0,3,3,False
2011-01-16,8,369,0,18,18,False
2011-01-16,9,370,3,29,32,False
2011-01-16,10,371,8,71,79,False
2011-01-16,11,372,23,70,93,False
2011-01-16,12,373,29,75,104,False
2011-01-16,13,374,23,95,118,False
2011-01-16,14,375,22,69,91,False
2011-01-16,15,376,35,78,113,False
2011-01-16,16,377,22,77,99,False
2011-01-16,17,378,23,82,105,False
2011-01-16,18,379,11,56,67,False
2011-01-16,19,380,14,47,61,False
2011-01-16,20,381,7,50,57,False
2011-01-16,21,382,6,22,28,False
2011-01-16,22,383,2,19,21,False
2011-01-16,23,384,0,18,18,False
2011-01-17,0,385,1,16,17,False
2011-01-17,1,386,1,15,16,False
2011-01-17,2,387,0,8,8,False
2011-01-17,3,388,0,2,2,False
2011-01-17,4,389,1,2,3,False
2011-01-17,5,390,0,1,1,False
2011-01-17,6,391,0,5,5,False
2011-01-17,7,392,4,9,13,False
2011-01-17,8,393,3,30,33,False
2011-01-17,9,394,8,39,47,False
2011-01-17,10,395,7,50,57,False
2011-01-17,11,396,9,55,64,False
2011-01-17,12,397,10,70,80,False
2011-01-17,13,398,13,80,93,False
2011-01-17,14,399,12,74,86,False
2011-01-17,15,400,21,72,93,False
2011-01-17,16,401,6,76,82,False
2011-01-17,17,402,4,67,71,False
2011-01-17,18,403,7,85,92,False
2011-01-17,19,404,2,58,60,False
2011-01-17,20,405,4,29,33,False
2011-01-17,21,406,3,24,27,False
2011-01-17,22,407,0,13,13,False
2011-01-17,23,408,1,3,4,False
2011-01-18,0,409,10,44,54,True
2011-01-18,1,410,7,27,34,True
2011-01-18,2,411,5,18,23,True
2011-01-18,3,412,3,9,12,True
2011-01-18,4,413,1,5,6,True
2011-01-18,5,414,1,18,19,True
2011-01-18,6,415,4,72,76,True
2011-01-18,7,416,11,201,212,True
2011-01-18,8,417,22,337,359,True
2011-01-18,9,418,31,188,219,True
2011-01-18,10,419,46,127,173,True
2011-01-18,11,420,60,149,209,True
2011-01-18,12,421,0,3,3,False
2011-01-18,13,422,0,22,22,False
2011-01-18,14,423,2,26,28,False
2011-01-18,15,424,3,32,35,False
2011-01-18,16,425,0,61,61,False
2011-01-18,17,426,1,124,125,False
2011-01-18,18,427,1,132,133,False
2011-01-18,19,428,1,98,99,False
2011-01-18,20,429,0,83,83,False
2011-01-18,21,430,0,41,41,False
2011-01-18,22,431,0,33,33,False
2011-01-18,23,432,1,19,20,False
2011-01-19,0,433,0,3,3,False
2011-01-19,1,434,1,6,7,False
2011-01-19,2,435,0,3,3,False
2011-01-19,3,436,3,9,12,True
2011-01-19,4,437,1,1,2,False
2011-01-19,5,438,0,7,7,False
2011-01-19,6,439,0,32,32,False
2011-01-19,7,440,1,89,90,False
2011-01-19,8,441,1,196,197,False
2011-01-19,9,442,2,107,109,False
2011-01-19,10,443,1,46,47,False
2011-01-19,11,444,5,47,52,False
2011-01-19,12,445,5,65,70,False
2011-01-19,13,446,11,67,78,False
2011-01-19,14,447,7,68,75,False
2011-01-19,15,448,4,78,82,False
2011-01-19,16,449,10,94,104,False
2011-01-19,17,450,7,190,197,False
2011-01-19,18,451,5,156,161,False
2011-01-19,19,452,4,108,112,False
2011-01-19,20,453,2,74,76,False
2011-01-19,21,454,4,55,59,False
2011-01-19,22,455,6,53,59,False
2011-01-19,23,456,1,27,28,False
2011-01-20,0,457,5,8,13,False
2011-01-20,1,458,2,3,5,False
2011-01-20,2,459,0,2,2,False
2011-01-20,3,460,0,1,1,False
2011-01-20,4,461,0,1,1,False
2011-01-20,5,462,0,6,6,False
2011-01-20,6,463,0,35,35,False
2011-01-20,7,464,1,100,101,False
2011-01-20,8,465,2,247,249,False
2011-01-20,9,466,3,140,143,False
2011-01-20,10,467,1,56,57,False
2011-01-20,11,468,5,63,68,False
2011-01-20,12,469,7,77,84,False
2011-01-20,13,470,12,86,98,False
2011-01-20,14,471,6,75,81,False
2011-01-20,15,472,8,62,70,False
2011-01-20,16,473,8,83,91,False
2011-01-20,17,474,8,207,215,False
2011-01-20,18,475,1,184,185,False
2011-01-20,19,476,6,146,152,False
2011-01-20,20,477,2,124,126,False
2011-01-20,21,478,3,54,57,False
2011-01-20,22,479,0,56,56,False
2011-01-20,23,480,3,28,31,False
2011-01-21,0,481,1,20,21,False
2011-01-21,1,482,0,6,6,False
2011-01-21,2,483,0,2,2,False
2011-01-21,3,484,0,1,1,False
2011-01-21,4,485,0,1,1,False
2011-01-21,5,486,1,4,5,False
2011-01-21,6,487,0,27,27,False
2011-01-21,7,488,2,66,68,False
2011-01-21,8,489,7,210,217,False
2011-01-21,9,490,7,159,166,False
2011-01-21,10,491,6,57,63,False
2011-01-21,11,492,6,53,59,False
2011-01-21,12,493,11,67,78,False
2011-01-21,13,494,8,65,73,False
2011-01-21,14,495,6,56,62,False
2011-01-21,15,496,4,61,65,False
2011-01-21,16,497,0,97,97,False
2011-01-21,17,498,10,151,161,False
2011-01-21,18,499,1,119,120,False
2011-01-21,19,500,3,93,96,False
2011-01-21,20,501,1,52,53,False
2011-01-21,21,502,0,41,41,False
2011-01-21,22,503,1,33,34,False
2011-01-21,23,504,0,27,27,False
2011-01-22,0,505,0,13,13,False
2011-01-22,1,506,3,9,12,False
2011-01-22,2,507,0,11,11,False
2011-01-22,3,508,1,6,7,False
2011-01-22,4,509,0,3,3,False
2011-01-22,5,510,1,18,19,True
2011-01-22,6,511,0,2,2,False
2011-01-22,7,512,0,8,8,False
2011-01-22,8,513,1,26,27,False
2011-01-22,9,514,3,37,40,False
2011-01-22,10,515,3,50,53,False
2011-01-22,11,516,4,59,63,False
2011-01-22,12,517,10,60,70,False
2011-01-22,13,518,12,72,84,False
2011-01-22,14,519,11,64,75,False
2011-01-22,15,520,10,93,103,False
2011-01-22,16,521,11,72,83,False
2011-01-22,17,522,8,59,67,False
2011-01-22,18,523,0,54,54,False
2011-01-22,19,524,6,53,59,False
2011-01-22,20,525,1,44,45,False
2011-01-22,21,526,0,39,39,False
2011-01-22,22,527,7,23,30,False
2011-01-22,23,528,2,31,33,False
2011-01-23,0,529,2,20,22,False
2011-01-23,1,530,1,12,13,False
2011-01-23,2,531,3,15,18,False
2011-01-23,3,532,1,4,5,False
2011-01-23,4,533,1,5,6,True
2011-01-23,5,534,0,3,3,False
2011-01-23,6,535,0,1,1,False
2011-01-23,7,536,1,1,2,False
2011-01-23,8,537,2,17,19,False
2011-01-23,9,538,3,25,28,False
2011-01-23,10,539,7,51,58,False
2011-01-23,11,540,22,77,99,False
2011-01-23,12,541,24,92,116,False
2011-01-23,13,542,12,75,87,False
2011-01-23,14,543,17,93,110,False
2011-01-23,15,544,13,64,77,False
2011-01-23,16,545,9,56,65,False
2011-01-23,17,546,5,50,55,False
2011-01-23,18,547,5,44,49,False
2011-01-23,19,548,5,45,50,False
2011-01-23,20,549,4,31,35,False
2011-01-23,21,550,5,20,25,False
2011-01-23,22,551,5,23,28,False
2011-01-23,23,552,4,17,21,False
2011-01-24,0,553,0,7,7,False
2011-01-24,1,554,0,1,1,False
2011-01-24,2,555,5,18,23,True
2011-01-24,3,556,0,1,1,False
2011-01-24,4,557,0,1,1,False
2011-01-24,5,558,0,5,5,False
2011-01-24,6,559,0,15,15,False
2011-01-24,7,560,5,79,84,False
2011-01-24,8,561,6,171,177,False
2011-01-24,9,562,4,98,102,False
2011-01-24,10,563,6,34,40,False
2011-01-24,11,564,3,43,46,False
2011-01-24,12,565,11,52,63,False
2011-01-24,13,566,6,54,60,False
2011-01-24,14,567,2,43,45,False
2011-01-24,15,568,7,50,57,False
2011-01-24,16,569,4,66,70,False
2011-01-24,17,570,6,178,184,False
2011-01-24,18,571,8,145,153,False
2011-01-24,19,572,5,101,106,False
2011-01-24,20,573,1,80,81,False
2011-01-24,21,574,6,53,59,False
2011-01-24,22,575,3,32,35,False
2011-01-24,23,576,3,21,24,False
2011-01-25,0,577,3,6,9,False
2011-01-25,1,578,0,5,5,False
2011-01-25,2,579,0,2,2,False
2011-01-25,3,580,3,9,12,True
2011-01-25,4,581,0,1,1,False
2011-01-25,5,582,0,9,9,False
2011-01-25,6,583,1,35,36,False
2011-01-25,7,584,5,103,108,False
2011-01-25,8,585,5,233,238,False
2011-01-25,9,586,10,134,144,False
2011-01-25,10,587,6,49,55,False
2011-01-25,11,588,6,55,61,False
2011-01-25,12,589,21,85,106,False
2011-01-25,13,590,21,72,93,False
2011-01-25,14,591,11,57,68,False
2011-01-25,15,592,21,63,84,False
2011-01-25,16,593,14,102,116,False
2011-01-25,17,594,14,208,222,False
2011-01-25,18,595,7,218,225,False
2011-01-25,19,596,13,133,146,False
2011-01-25,20,597,16,103,119,False
2011-01-25,21,598,5,40,45,False
2011-01-25,22,599,4,49,53,False
2011-01-25,23,600,3,37,40,False
2011-01-26,0,601,3,14,17,False
2011-01-26,1,602,0,5,5,False
2011-01-26,2,603,3,7,10,False
2011-01-26,3,604,3,9,12,True
2011-01-26,4,605,1,5,6,True
2011-01-26,5,606,0,1,1,False
2011-01-26,6,607,0,8,8,False
2011-01-26,7,608,1,29,30,False
2011-01-26,8,609,3,69,72,False
2011-01-26,9,610,3,55,58,False
2011-01-26,10,611,2,26,28,False
2011-01-26,11,612,6,35,41,False
2011-01-26,12,613,7,41,48,False
2011-01-26,13,614,4,43,47,False
2011-01-26,14,615,0,36,36,False
2011-01-26,15,616,1,42,43,False
2011-01-26,16,617,1,35,36,False
2011-01-26,17,618,0,26,26,False
2011-01-26,18,619,61,364,425,True
2011-01-26,19,620,49,263,312,True
2011-01-26,20,621,36,190,226,True
2011-01-26,21,622,28,144,172,True
2011-01-26,22,623,22,109,131,True
2011-01-26,23,624,15,73,88,True
2011-01-27,0,625,10,44,54,True
2011-01-27,1,626,7,27,34,True
2011-01-27,2,627,5,18,23,True
2011-01-27,3,628,3,9,12,True
2011-01-27,4,629,1,5,6,True
2011-01-27,5,630,1,18,19,True
2011-01-27,6,631,4,72,76,True
2011-01-27,7,632,11,201,212,True
2011-01-27,8,633,22,337,359,True
2011-01-27,9,634,31,188,219,True
2011-01-27,10,635,46,127,173,True
2011-01-27,11,636,60,149,209,True
2011-01-27,12,637,68,185,253,True
2011-01-27,13,638,72,181,253,True
2011-01-27,14,639,76,165,241,True
2011-01-27,15,640,75,176,251,True
2011-01-27,16,641,1,23,24,False
2011-01-27,17,642,2,82,84,False
2011-01-27,18,643,3,101,104,False
2011-01-27,19,644,3,76,79,False
2011-01-27,20,645,4,55,59,False
2011-01-27,21,646,2,36,38,False
2011-01-27,22,647,0,27,27,False
2011-01-27,23,648,0,16,16,False
2011-01-28,0,649,0,9,9,False
2011-01-28,1,650,1,2,3,False
2011-01-28,2,651,0,2,2,False
2011-01-28,3,652,1,0,1,False
2011-01-28,4,653,1,5,6,True
2011-01-28,5,654,0,4,4,False
2011-01-28,6,655,0,16,16,False
2011-01-28,7,656,2,58,60,False
2011-01-28,8,657,2,155,157,False
2011-01-28,9,658,6,95,101,False
2011-01-28,10,659,0,49,49,False
2011-01-28,11,660,0,30,30,False
2011-01-28,12,661,1,28,29,False
2011-01-28,13,662,0,31,31,False
2011-01-28,14,663,2,36,38,False
2011-01-28,15,664,1,40,41,False
2011-01-28,16,665,10,70,80,False
2011-01-28,17,666,2,147,149,False
2011-01-28,18,667,2,107,109,False
2011-01-28,19,668,5,84,89,False
2011-01-28,20,669,1,61,62,False
2011-01-28,21,670,1,57,58,False
2011-01-28,22,671,0,26,26,False
2011-01-28,23,672,1,22,23,False
2011-01-29,0,673,2,26,28,False
2011-01-29,1,674,0,20,20,False
2011-01-29,2,675,0,15,15,False
2011-01-29,3,676,3,5,8,False
2011-01-29,4,677,1,2,3,False
2011-01-29,5,678,1,18,19,True
2011-01-29,6,679,0,2,2,False
2011-01-29,7,680,1,4,5,False
2011-01-29,8,681,3,31,34,False
2011-01-29,9,682,0,34,34,False
2011-01-29,10,683,4,51,55,False
2011-01-29,11,684,4,60,64,False
2011-01-29,12,685,12,66,78,False
2011-01-29,13,686,9,56,65,False
2011-01-29,14,687,10,89,99,False
2011-01-29,15,688,22,98,120,False
2011-01-29,16,689,19,88,107,False
2011-01-29,17,690,9,82,91,False
2011-01-29,18,691,9,59,68,False
2011-01-29,19,692,6,52,58,False
2011-01-29,20,693,1,42,43,False
2011-01-29,21,694,1,35,36,False
2011-01-29,22,695,4,28,32,False
2011-01-29,23,696,3,30,33,False
2011-01-30,0,697,0,33,33,False
2011-01-30,1,698,7,22,29,False
2011-01-30,2,699,1,10,11,False
2011-01-30,3,700,1,7,8,False
2011-01-30,4,701,0,1,1,False
2011-01-30,5,702,0,3,3,False
2011-01-30,6,703,4,72,76,True
2011-01-30,7,704,0,3,3,False
2011-01-30,8,705,1,11,12,False
2011-01-30,9,706,4,34,38,False
2011-01-30,10,707,7,57,64,False
2011-01-30,11,708,9,50,59,False
2011-01-30,12,709,10,87,97,False
2011-01-30,13,710,13,71,84,False
2011-01-30,14,711,18,104,122,False
2011-01-30,15,712,14,95,109,False
2011-01-30,16,713,19,104,123,False
2011-01-30,17,714,6,71,77,False
2011-01-30,18,715,8,57,65,False
2011-01-30,19,716,9,46,55,False
2011-01-30,20,717,3,30,33,False
2011-01-30,21,718,3,25,28,False
2011-01-30,22,719,2,19,21,False
2011-01-30,23,720,5,16,21,False
2011-01-31,0,721,1,6,7,False
2011-01-31,1,722,2,5,7,False
2011-01-31,2,723,0,1,1,False
2011-01-31,3,724,0,2,2,False
2011-01-31,4,725,0,2,2,False
2011-01-31,5,726,0,8,8,False
2011-01-31,6,727,0,37,37,False
2011-01-31,7,728,1,71,72,False
2011-01-31,8,729,3,182,185,False
2011-01-31,9,730,0,112,112,False
2011-01-31,10,731,1,68,69,False
2011-01-31,11,732,2,46,48,False
2011-01-31,12,733,6,62,68,False
2011-01-31,13,734,2,52,54,False
2011-01-31,14,735,1,85,86,False
2011-01-31,15,736,3,41,44,False
2011-01-31,16,737,3,83,86,False
2011-01-31,17,738,6,155,161,False
2011-01-31,18,739,3,153,156,False
2011-01-31,19,740,3,108,111,False
2011-01-31,20,741,0,78,78,False
2011-01-31,21,742,3,53,56,False
2011-01-31,22,743,0,34,34,False
2011-01-31,23,744,2,15,17,False
2011-02-01,0,745,2,6,8,False
2011-02-01,1,746,0,3,3,False
2011-02-01,2,747,0,2,2,False
2011-02-01,3,748,0,2,2,False
2011-02-01,4,749,1,5,6,True
2011-02-01,5,750,0,3,3,False
2011-02-01,6,751,0,22,22,False
2011-02-01,7,752,0,52,52,False
2011-02-01,8,753,3,132,135,False
2011-02-01,9,754,2,114,116,False
2011-02-01,10,755,0,47,47,False
2011-02-01,11,756,2,49,51,False
2011-02-01,12,757,2,53,55,False
2011-02-01,13,758,3,49,52,False
2011-02-01,14,759,5,49,54,False
2011-02-01,15,760,7,45,52,False
2011-02-01,16,761,3,61,64,False
2011-02-01,17,762,4,172,176,False
2011-02-01,18,763,3,165,168,False
2011-02-01,19,764,3,105,108,False
2011-02-01,20,765,5,69,74,False
2011-02-01,21,766,0,64,64,False
2011-02-01,22,767,2,34,36,False
2011-02-01,23,768,1,15,16,False
2011-02-02,0,769,0,2,2,False
2011-02-02,1,770,0,3,3,False
2011-02-02,2,771,4,0,4,False
2011-02-02,3,772,0,1,1,False
2011-02-02,4,773,0,1,1,False
2011-02-02,5,774,0,3,3,False
2011-02-02,6,775,1,17,18,False
2011-02-02,7,776,1,48,49,False
2011-02-02,8,777,1,154,155,False
2011-02-02,9,778,4,119,123,False
2011-02-02,10,779,2,59,61,False
2011-02-02,11,780,5,47,52,False
2011-02-02,12,781,3,61,64,False
2011-02-02,13,782,1,74,75,False
2011-02-02,14,783,2,61,63,False
2011-02-02,15,784,10,66,76,False
2011-02-02,16,785,8,95,103,False
2011-02-02,17,786,7,183,190,False
2011-02-02,18,787,7,175,182,False
2011-02-02,19,788,3,88,91,False
2011-02-02,20,789,4,71,75,False
2011-02-02,21,790,1,62,63,False
2011-02-02,22,791,5,35,40,False
2011-02-02,23,792,3,29,32,False
2011-02-03,0,793,1,11,12,False
2011-02-03,1,794,0,5,5,False
2011-02-03,2,795,0,2,2,False
2011-02-03,3,796,0,1,1,False
2011-02-03,4,797,1,5,6,True
2011-02-03,5,798,0,2,2,False
2011-02-03,6,799,0,39,39,False
2011-02-03,7,800,1,86,87,False
2011-02-03,8,801,4,184,188,False
2011-02-03,9,802,6,127,133,False
2011-02-03,10,803,2,50,52,False
2011-02-03,11,804,9,55,64,False
2011-02-03,12,805,2,67,69,False
2011-02-03,13,806,4,47,51,False
2011-02-03,14,807,4,43,47,False
2011-02-03,15,808,4,56,60,False
2011-02-03,16,809,5,73,78,False
2011-02-03,17,810,5,170,175,False
2011-02-03,18,811,2,145,147,False
2011-02-03,19,812,4,92,96,False
2011-02-03,20,813,1,108,109,False
2011-02-03,21,814,1,53,54,False
2011-02-03,22,815,2,39,41,False
2011-02-03,23,816,4,34,38,False
2011-02-04,0,817,3,10,13,False
2011-02-04,1,818,0,7,7,False
2011-02-04,2,819,0,1,1,False
2011-02-04,3,820,0,1,1,False
2011-02-04,4,821,1,5,6,True
2011-02-04,5,822,0,7,7,False
2011-02-04,6,823,2,26,28,False
2011-02-04,7,824,0,87,87,False
2011-02-04,8,825,3,217,220,False
2011-02-04,9,826,3,124,127,False
2011-02-04,10,827,5,46,51,False
2011-02-04,11,828,3,61,64,False
2011-02-04,12,829,8,78,86,False
2011-02-04,13,830,9,73,82,False
2011-02-04,14,831,15,76,91,False
2011-02-04,15,832,9,81,90,False
2011-02-04,16,833,8,91,99,False
2011-02-04,17,834,10,195,205,False
2011-02-04,18,835,3,152,155,False
2011-02-04,19,836,1,102,103,False
2011-02-04,20,837,2,69,71,False
2011-02-04,21,838,2,41,43,False
2011-02-04,22,839,1,45,46,False
2011-02-04,23,840,1,30,31,False
2011-02-05,0,841,3,36,39,False
2011-02-05,1,842,1,17,18,False
2011-02-05,2,843,5,12,17,False
2011-02-05,3,844,1,10,11,False
2011-02-05,4,845,0,8,8,False
2011-02-05,5,846,0,9,9,False
2011-02-05,6,847,0,4,4,False
2011-02-05,7,848,0,4,4,False
2011-02-05,8,849,0,10,10,False
2011-02-05,9,850,3,17,20,False
2011-02-05,10,851,3,31,34,False
2011-02-05,11,852,1,46,47,False
2011-02-05,12,853,10,42,52,False
2011-02-05,13,854,10,62,72,False
2011-02-05,14,855,5,50,55,False
2011-02-05,15,856,11,49,60,False
2011-02-05,16,857,8,63,71,False
2011-02-05,17,858,14,64,78,False
2011-02-05,18,859,2,81,83,False
2011-02-05,19,860,6,78,84,False
2011-02-05,20,861,5,64,69,False
2011-02-05,21,862,3,53,56,False
2011-02-05,22,863,2,43,45,False
2011-02-05,23,864,7,52,59,False
2011-02-06,0,865,2,37,39,False
2011-02-06,1,866,4,40,44,False
2011-02-06,2,867,0,20,20,False
2011-02-06,3,868,3,10,13,False
2011-02-06,4,869,0,2,2,False
2011-02-06,5,870,0,1,1,False
2011-02-06,6,871,0,1,1,False
2011-02-06,7,872,0,8,8,False
2011-02-06,8,873,2,21,23,False
2011-02-06,9,874,7,38,45,False
2011-02-06,10,875,15,74,89,False
2011-02-06,11,876,28,89,117,False
2011-02-06,12,877,48,126,174,False
2011-02-06,13,878,47,135,182,False
2011-02-06,14,879,47,114,161,False
2011-02-06,15,880,52,130,182,False
2011-02-06,16,881,42,115,157,False
2011-02-06,17,882,24,97,121,False
2011-02-06,18,883,13,65,78,False
2011-02-06,19,884,1,20,21,False
2011-02-06,20,885,5,21,26,False
2011-02-06,21,886,5,22,27,False
2011-02-06,22,887,5,57,62,False
2011-02-06,23,888,4,26,30,False
2011-02-07,0,889,1,14,15,False
2011-02-07,1,890,1,4,5,False
2011-02-07,2,891,0,3,3,False
2011-02-07,3,892,0,1,1,False
2011-02-07,4,893,1,1,2,False
2011-02-07,5,894,1,9,10,False
2011-02-07,6,895,1,29,30,False
2011-02-07,7,896,6,89,95,False
2011-02-07,8,897,7,223,230,False
2011-02-07,9,898,3,115,118,False
2011-02-07,10,899,6,49,55,False
2011-02-07,11,900,11,36,47,False
2011-02-07,12,901,7,59,66,False
2011-02-07,13,902,10,54,64,False
2011-02-07,14,903,8,52,60,False
2011-02-07,15,904,4,46,50,False
2011-02-07,16,905,16,98,114,False
2011-02-07,17,906,9,207,216,False
2011-02-07,18,907,5,170,175,False
2011-02-07,19,908,5,123,128,False
2011-02-07,20,909,6,82,88,False
2011-02-07,21,910,3,75,78,False
2011-02-07,22,911,3,34,37,False
2011-02-07,23,912,6,19,25,False
2011-02-08,0,913,4,6,10,False
2011-02-08,1,914,0,4,4,False
2011-02-08,2,915,1,1,2,False
2011-02-08,3,916,0,1,1,False
2011-02-08,4,917,0,3,3,False
2011-02-08,5,918,0,2,2,False
2011-02-08,6,919,0,39,39,False
2011-02-08,7,920,3,97,100,False
2011-02-08,8,921,7,236,243,False
2011-02-08,9,922,7,128,135,False
2011-02-08,10,923,4,44,48,False
2011-02-08,11,924,1,49,50,False
2011-02-08,12,925,2,63,65,False
2011-02-08,13,926,2,48,50,False
2011-02-08,14,927,3,61,64,False
2011-02-08,15,928,6,45,51,False
2011-02-08,16,929,4,79,83,False
2011-02-08,17,930,4,172,176,False
2011-02-08,18,931,1,151,152,False
2011-02-08,19,932,1,100,101,False
2011-02-08,20,933,3,53,56,False
2011-02-08,21,934,8,46,54,False
2011-02-08,22,935,0,29,29,False
2011-02-08,23,936,3,9,12,False
2011-02-09,0,937,0,17,17,False
2011-02-09,1,938,0,7,7,False
2011-02-09,2,939,1,2,3,False
2011-02-09,3,940,0,2,2,False
2011-02-09,4,941,1,5,6,True
2011-02-09,5,942,0,7,7,False
2011-02-09,6,943,0,43,43,False
2011-02-09,7,944,4,95,99,False
2011-02-09,8,945,1,198,199,False
2011-02-09,9,946,4,119,123,False
2011-02-09,10,947,8,51,59,False
2011-02-09,11,948,1,40,41,False
2011-02-09,12,949,4,57,61,False
2011-02-09,13,950,2,67,69,False
2011-02-09,14,951,2,56,58,False
2011-02-09,15,952,3,61,64,False
2011-02-09,16,953,7,72,79,False
2011-02-09,17,954,9,157,166,False
2011-02-09,18,955,2,168,170,False
2011-02-09,19,956,1,87,88,False
2011-02-09,20,957,0,84,84,False
2011-02-09,21,958,0,83,83,False
2011-02-09,22,959,4,42,46,False
2011-02-09,23,960,0,37,37,False
2011-02-10,0,961,0,16,16,False
2011-02-10,1,962,0,7,7,False
2011-02-10,2,963,0,3,3,False
2011-02-10,3,964,3,9,12,True
2011-02-10,4,965,0,1,1,False
2011-02-10,5,966,0,6,6,False
2011-02-10,6,967,0,26,26,False
2011-02-10,7,968,0,99,99,False
2011-02-10,8,969,5,173,178,False
2011-02-10,9,970,1,121,122,False
2011-02-10,10,971,1,34,35,False
2011-02-10,11,972,1,44,45,False
2011-02-10,12,973,4,65,69,False
2011-02-10,13,974,3,59,62,False
2011-02-10,14,975,6,42,48,False
2011-02-10,15,976,0,50,50,False
2011-02-10,16,977,4,76,80,False
2011-02-10,17,978,6,159,165,False
2011-02-10,18,979,3,157,160,False
2011-02-10,19,980,2,110,112,False
2011-02-10,20,981,4,93,97,False
2011-02-10,21,982,2,70,72,False
2011-02-10,22,983,4,47,51,False
2011-02-10,23,984,1,33,34,False
2011-02-11,0,985,2,12,14,False
2011-02-11,1,986,1,6,7,False
2011-02-11,2,987,0,3,3,False
2011-02-11,3,988,3,9,12,True
2011-02-11,4,989,1,5,6,True
2011-02-11,5,990,0,4,4,False
2011-02-11,6,991,1,23,24,False
2011-02-11,7,992,1,73,74,False
2011-02-11,8,993,4,212,216,False
2011-02-11,9,994,8,132,140,False
2011-02-11,10,995,5,39,44,False
2011-02-11,11,996,12,52,64,False
2011-02-11,12,997,7,64,71,False
2011-02-11,13,998,21,89,110,False
2011-02-11,14,999,17,67,84,False
2011-02-11,15,1000,12,62,74,False
2011-02-11,16,1001,14,111,125,False
2011-02-11,17,1002,18,193,211,False
2011-02-11,18,1003,9,165,174,False
2011-02-11,19,1004,7,94,101,False
2011-02-11,20,1005,2,61,63,False
2011-02-11,21,1006,1,46,47,False
2011-02-11,22,1007,2,41,43,False
2011-02-11,23,1008,5,48,53,False
2011-02-12,0,1009,3,27,30,False
2011-02-12,1,1010,2,22,24,False
2011-02-12,2,1011,2,13,15,False
2011-02-12,3,1012,3,7,10,False
2011-02-12,4,1013,0,4,4,False
2011-02-12,5,1014,0,1,1,False
2011-02-12,6,1015,1,1,2,False
2011-02-12,7,1016,2,9,11,False
2011-02-12,8,1017,2,28,30,False
2011-02-12,9,1018,5,38,43,False
2011-02-12,10,1019,13,71,84,False
2011-02-12,11,1020,30,84,114,False
2011-02-12,12,1021,27,93,120,False
2011-02-12,13,1022,32,103,135,False
2011-02-12,14,1023,30,90,120,False
2011-02-12,15,1024,47,127,174,False
2011-02-12,16,1025,42,103,145,False
2011-02-12,17,1026,24,113,137,False
2011-02-12,18,1027,4,60,64,False
2011-02-12,19,1028,2,39,41,False
2011-02-12,20,1029,1,39,40,False
2011-02-12,21,1030,9,42,51,False
2011-02-12,22,1031,6,39,45,False
2011-02-12,23,1032,1,31,32,False
2011-02-13,0,1033,5,34,39,False
2011-02-13,1,1034,1,23,24,False
2011-02-13,2,1035,1,19,20,False
2011-02-13,3,1036,4,8,12,False
2011-02-13,4,1037,0,2,2,False
2011-02-13,5,1038,1,18,19,True
2011-02-13,6,1039,2,3,5,False
2011-02-13,7,1040,0,3,3,False
2011-02-13,8,1041,1,11,12,False
2011-02-13,9,1042,12,35,47,False
2011-02-13,10,1043,19,86,105,False
2011-02-13,11,1044,26,86,112,False
2011-02-13,12,1045,58,94,152,False
2011-02-13,13,1046,62,92,154,False
2011-02-13,14,1047,51,110,161,False
2011-02-13,15,1048,40,122,162,False
2011-02-13,16,1049,28,106,134,False
2011-02-13,17,1050,30,95,125,False
2011-02-13,18,1051,17,78,95,False
2011-02-13,19,1052,11,50,61,False
2011-02-13,20,1053,15,32,47,False
2011-02-13,21,1054,6,45,51,False
2011-02-13,22,1055,5,31,36,False
2011-02-13,23,1056,3,27,30,False
2011-02-14,0,1057,3,8,11,False
2011-02-14,1,1058,1,6,7,False
2011-02-14,2,1059,0,2,2,False
2011-02-14,3,1060,1,1,2,False
2011-02-14,4,1061,0,2,2,False
2011-02-14,5,1062,0,3,3,False
2011-02-14,6,1063,1,25,26,False
2011-02-14,7,1064,2,96,98,False
2011-02-14,8,1065,7,249,256,False
2011-02-14,9,1066,8,122,130,False
2011-02-14,10,1067,9,46,55,False
2011-02-14,11,1068,10,43,53,False
2011-02-14,12,1069,27,99,126,False
2011-02-14,13,1070,27,93,120,False
2011-02-14,14,1071,14,76,90,False
2011-02-14,15,1072,19,71,90,False
2011-02-14,16,1073,16,102,118,False
2011-02-14,17,1074,25,218,243,False
2011-02-14,18,1075,11,194,205,False
2011-02-14,19,1076,12,86,98,False
2011-02-14,20,1077,5,65,70,False
2011-02-14,21,1078,8,35,43,False
2011-02-14,22,1079,1,44,45,False
2011-02-14,23,1080,1,19,20,False
2011-02-15,0,1081,7,12,19,False
2011-02-15,1,1082,0,5,5,False
2011-02-15,2,1083,1,2,3,False
2011-02-15,3,1084,3,9,12,True
2011-02-15,4,1085,0,1,1,False
2011-02-15,5,1086,0,4,4,False
2011-02-15,6,1087,0,30,30,False
2011-02-15,7,1088,2,103,105,False
2011-02-15,8,1089,10,213,223,False
2011-02-15,9,1090,2,108,110,False
2011-02-15,10,1091,5,47,52,False
2011-02-15,11,1092,11,46,57,False
2011-02-15,12,1093,6,65,71,False
2011-02-15,13,1094,14,68,82,False
2011-02-15,14,1095,10,69,79,False
2011-02-15,15,1096,11,74,85,False
2011-02-15,16,1097,21,77,98,False
2011-02-15,17,1098,15,191,206,False
2011-02-15,18,1099,14,198,212,False
2011-02-15,19,1100,3,142,145,False
2011-02-15,20,1101,3,98,101,False
2011-02-15,21,1102,5,61,66,False
2011-02-15,22,1103,0,41,41,False
2011-02-15,23,1104,0,20,20,False
2011-02-16,0,1105,0,15,15,False
2011-02-16,1,1106,0,9,9,False
2011-02-16,2,1107,5,18,23,True
2011-02-16,3,1108,0,1,1,False
2011-02-16,4,1109,0,1,1,False
2011-02-16,5,1110,0,5,5,False
2011-02-16,6,1111,1,32,33,False
2011-02-16,7,1112,5,103,108,False
2011-02-16,8,1113,6,224,230,False
2011-02-16,9,1114,2,122,124,False
2011-02-16,10,1115,14,55,69,False
2011-02-16,11,1116,7,59,66,False
2011-02-16,12,1117,14,72,86,False
2011-02-16,13,1118,13,80,93,False
2011-02-16,14,1119,17,65,82,False
2011-02-16,15,1120,35,82,117,False
2011-02-16,16,1121,26,96,122,False
2011-02-16,17,1122,11,244,255,False
2011-02-16,18,1123,20,202,222,False
2011-02-16,19,1124,18,143,161,False
2011-02-16,20,1125,10,108,118,False
2011-02-16,21,1126,5,87,92,False
2011-02-16,22,1127,12,61,73,False
2011-02-16,23,1128,2,31,33,False
2011-02-17,0,1129,1,16,17,False
2011-02-17,1,1130,0,6,6,False
2011-02-17,2,1131,2,4,6,False
2011-02-17,3,1132,3,1,4,False
2011-02-17,4,1133,3,1,4,False
2011-02-17,5,1134,1,11,12,False
2011-02-17,6,1135,3,44,47,False
2011-02-17,7,1136,7,119,126,False
2011-02-17,8,1137,18,267,285,False
2011-02-17,9,1138,16,163,179,False
2011-02-17,10,1139,18,70,88,False
2011-02-17,11,1140,19,71,90,False
2011-02-17,12,1141,15,86,101,False
2011-02-17,13,1142,15,108,123,False
2011-02-17,14,1143,26,55,81,False
2011-02-17,15,1144,15,91,106,False
2011-02-17,16,1145,29,117,146,False
2011-02-17,17,1146,18,256,274,False
2011-02-17,18,1147,11,211,222,False
2011-02-17,19,1148,14,161,175,False
2011-02-17,20,1149,8,131,139,False
2011-02-17,21,1150,5,119,124,False
2011-02-17,22,1151,8,68,76,False
2011-02-17,23,1152,4,40,44,False
2011-02-18,0,1153,12,20,32,False
2011-02-18,1,1154,1,7,8,False
2011-02-18,2,1155,2,5,7,False
2011-02-18,3,1156,2,6,8,False
2011-02-18,4,1157,0,1,1,False
2011-02-18,5,1158,1,6,7,False
2011-02-18,6,1159,2,48,50,False
2011-02-18,7,1160,8,108,116,False
2011-02-18,8,1161,26,246,272,False
2011-02-18,9,1162,15,154,169,False
2011-02-18,10,1163,17,78,95,False
2011-02-18,11,1164,31,82,113,False
2011-02-18,12,1165,59,126,185,False
2011-02-18,13,1166,45,131,176,False
2011-02-18,14,1167,73,118,191,False
2011-02-18,15,1168,55,117,172,False
2011-02-18,16,1169,68,164,232,False
2011-02-18,17,1170,52,275,327,False
2011-02-18,18,1171,29,195,224,False
2011-02-18,19,1172,16,146,162,False
2011-02-18,20,1173,19,105,124,False
2011-02-18,21,1174,11,61,72,False
2011-02-18,22,1175,19,88,107,False
2011-02-18,23,1176,16,61,77,False
2011-02-19,0,1177,6,23,29,False
2011-02-19,1,1178,10,21,31,False
2011-02-19,2,1179,3,14,17,False
2011-02-19,3,1180,0,7,7,False
2011-02-19,4,1181,0,3,3,False
2011-02-19,5,1182,0,3,3,False
2011-02-19,6,1183,3,3,6,False
2011-02-19,7,1184,6,16,22,False
2011-02-19,8,1185,9,36,45,False
2011-02-19,9,1186,18,37,55,False
2011-02-19,10,1187,34,72,106,False
2011-02-19,11,1188,47,76,123,False
2011-02-19,12,1189,38,81,119,False
2011-02-19,13,1190,52,103,155,False
2011-02-19,14,1191,102,94,196,False
2011-02-19,15,1192,84,87,171,False
2011-02-19,16,1193,39,81,120,False
2011-02-19,17,1194,36,91,127,False
2011-02-19,18,1195,21,67,88,False
2011-02-19,19,1196,5,54,59,False
2011-02-19,20,1197,9,38,47,False
2011-02-19,21,1198,4,29,33,False
2011-02-19,22,1199,2,42,44,False
2011-02-19,23,1200,4,25,29,False
2011-02-20,0,1201,3,14,17,False
2011-02-20,1,1202,5,11,16,False
2011-02-20,2,1203,0,17,17,False
2011-02-20,3,1204,9,9,18,False
2011-02-20,4,1205,0,1,1,False
2011-02-20,5,1206,1,18,19,True
2011-02-20,6,1207,1,1,2,False
2011-02-20,7,1208,0,2,2,False
2011-02-20,8,1209,2,22,24,False
2011-02-20,9,1210,7,48,55,False
2011-02-20,10,1211,34,70,104,False
2011-02-20,11,1212,72,89,161,False
2011-02-20,12,1213,62,120,182,False
2011-02-20,13,1214,76,122,198,False
2011-02-20,14,1215,108,104,212,False
2011-02-20,15,1216,66,102,168,False
2011-02-20,16,1217,59,88,147,False
2011-02-20,17,1218,60,86,146,False
2011-02-20,18,1219,30,71,101,False
2011-02-20,19,1220,3,39,42,False
2011-02-20,20,1221,12,30,42,False
2011-02-20,21,1222,17,39,56,False
2011-02-20,22,1223,4,43,47,False
2011-02-20,23,1224,9,45,54,False
2011-02-21,0,1225,7,30,37,False
2011-02-21,1,1226,2,11,13,False
2011-02-21,2,1227,1,3,4,False
2011-02-21,3,1228,2,3,5,False
2011-02-21,4,1229,1,0,1,False
2011-02-21,5,1230,1,2,3,False
2011-02-21,6,1231,2,6,8,False
2011-02-21,7,1232,3,16,19,False
2011-02-21,8,1233,7,56,63,False
2011-02-21,9,1234,11,46,57,False
2011-02-21,10,1235,29,52,81,False
2011-02-21,11,1236,20,70,90,False
2011-02-21,12,1237,26,67,93,False
2011-02-21,13,1238,28,75,103,False
2011-02-21,14,1239,15,101,116,False
2011-02-21,15,1240,11,76,87,False
2011-02-21,16,1241,8,48,56,False
2011-02-21,17,1242,18,62,80,False
2011-02-21,18,1243,2,64,66,False
2011-02-21,19,1244,0,49,49,False
2011-02-21,20,1245,0,29,29,False
2011-02-21,21,1246,1,33,34,False
2011-02-21,22,1247,0,11,11,False
2011-02-21,23,1248,0,2,2,False
2011-02-22,0,1249,10,44,54,True
2011-02-22,1,1250,7,27,34,True
2011-02-22,2,1251,5,18,23,True
2011-02-22,3,1252,3,9,12,True
2011-02-22,4,1253,1,5,6,True
2011-02-22,5,1254,1,18,19,True
2011-02-22,6,1255,0,7,7,False
2011-02-22,7,1256,0,40,40,False
2011-02-22,8,1257,7,107,114,False
2011-02-22,9,1258,5,101,106,False
2011-02-22,10,1259,0,44,44,False
2011-02-22,11,1260,7,43,50,False
2011-02-22,12,1261,7,48,55,False
2011-02-22,13,1262,3,52,55,False
2011-02-22,14,1263,9,49,58,False
2011-02-22,15,1264,2,67,69,False
2011-02-22,16,1265,7,79,86,False
2011-02-22,17,1266,8,188,196,False
2011-02-22,18,1267,6,161,167,False
2011-02-22,19,1268,4,114,118,False
2011-02-22,20,1269,3,102,105,False
2011-02-22,21,1270,2,80,82,False
2011-02-22,22,1271,1,76,77,False
2011-02-22,23,1272,3,18,21,False
2011-02-23,0,1273,0,6,6,False
2011-02-23,1,1274,0,4,4,False
2011-02-23,2,1275,0,1,1,False
2011-02-23,3,1276,0,2,2,False
2011-02-23,4,1277,1,5,6,True
2011-02-23,5,1278,0,8,8,False
2011-02-23,6,1279,0,36,36,False
2011-02-23,7,1280,2,94,96,False
2011-02-23,8,1281,8,227,235,False
2011-02-23,9,1282,9,130,139,False
2011-02-23,10,1283,4,47,51,False
2011-02-23,11,1284,16,53,69,False
2011-02-23,12,1285,11,56,67,False
2011-02-23,13,1286,9,78,87,False
2011-02-23,14,1287,17,61,78,False
2011-02-23,15,1288,18,54,72,False
2011-02-23,16,1289,15,79,94,False
2011-02-23,17,1290,15,207,222,False
2011-02-23,18,1291,3,206,209,False
2011-02-23,19,1292,6,135,141,False
2011-02-23,20,1293,2,107,109,False
2011-02-23,21,1294,2,89,91,False
2011-02-23,22,1295,1,60,61,False
2011-02-23,23,1296,1,38,39,False
2011-02-24,0,1297,0,11,11,False
2011-02-24,1,1298,0,7,7,False
2011-02-24,2,1299,0,4,4,False
2011-02-24,3,1300,0,2,2,False
2011-02-24,4,1301,1,5,6,True
2011-02-24,5,1302,1,3,4,False
2011-02-24,6,1303,0,58,58,False
2011-02-24,7,1304,0,104,104,False
2011-02-24,8,1305,8,244,252,False
2011-02-24,9,1306,4,133,137,False
2011-02-24,10,1307,8,49,57,False
2011-02-24,11,1308,8,71,79,False
2011-02-24,12,1309,10,85,95,False
2011-02-24,13,1310,16,72,88,False
2011-02-24,14,1311,2,67,69,False
2011-02-24,15,1312,5,58,63,False
2011-02-24,16,1313,4,67,71,False
2011-02-24,17,1314,9,168,177,False
2011-02-24,18,1315,5,132,137,False
2011-02-24,19,1316,3,112,115,False
2011-02-24,20,1317,2,87,89,False
2011-02-24,21,1318,7,76,83,False
2011-02-24,22,1319,5,50,55,False
2011-02-24,23,1320,3,47,50,False
2011-02-25,0,1321,1,8,9,False
2011-02-25,1,1322,1,9,10,False
2011-02-25,2,1323,0,3,3,False
2011-02-25,3,1324,1,1,2,False
2011-02-25,4,1325,1,5,6,True
2011-02-25,5,1326,1,5,6,False
2011-02-25,6,1327,0,11,11,False
2011-02-25,7,1328,1,34,35,False
2011-02-25,8,1329,3,70,73,False
2011-02-25,9,1330,3,111,114,False
2011-02-25,10,1331,7,42,49,False
2011-02-25,11,1332,9,50,59,False
2011-02-25,12,1333,20,95,115,False
2011-02-25,13,1334,6,77,83,False
2011-02-25,14,1335,14,71,85,False
2011-02-25,15,1336,5,50,55,False
2011-02-25,16,1337,11,91,102,False
2011-02-25,17,1338,8,181,189,False
2011-02-25,18,1339,7,150,157,False
2011-02-25,19,1340,4,86,90,False
2011-02-25,20,1341,2,60,62,False
2011-02-25,21,1342,7,56,63,False
2011-02-25,22,1343,7,43,50,False
2011-02-25,23,1344,2,37,39,False
2011-02-26,0,1345,3,25,28,False
2011-02-26,1,1346,2,25,27,False
2011-02-26,2,1347,3,9,12,False
2011-02-26,3,1348,1,7,8,False
2011-02-26,4,1349,1,1,2,False
2011-02-26,5,1350,1,9,10,False
2011-02-26,6,1351,1,6,7,False
2011-02-26,7,1352,1,21,22,False
2011-02-26,8,1353,2,55,57,False
2011-02-26,9,1354,9,65,74,False
2011-02-26,10,1355,14,71,85,False
2011-02-26,11,1356,26,100,126,False
2011-02-26,12,1357,45,115,160,False
2011-02-26,13,1358,38,136,174,False
2011-02-26,14,1359,57,154,211,False
2011-02-26,15,1360,40,125,165,False
2011-02-26,16,1361,41,130,171,False
2011-02-26,17,1362,53,130,183,False
2011-02-26,18,1363,26,111,137,False
2011-02-26,19,1364,30,64,94,False
2011-02-26,20,1365,8,60,68,False
2011-02-26,21,1366,9,59,68,False
2011-02-26,22,1367,8,38,46,False
2011-02-26,23,1368,5,29,34,False
2011-02-27,0,1369,8,26,34,False
2011-02-27,1,1370,7,30,37,False
2011-02-27,2,1371,2,20,22,False
2011-02-27,3,1372,3,8,11,False
2011-02-27,4,1373,0,2,2,False
2011-02-27,5,1374,1,18,19,True
2011-02-27,6,1375,2,1,3,False
2011-02-27,7,1376,6,8,14,False
2011-02-27,8,1377,9,26,35,False
2011-02-27,9,1378,17,42,59,False
2011-02-27,10,1379,24,79,103,False
2011-02-27,11,1380,33,92,125,False
2011-02-27,12,1381,61,132,193,False
2011-02-27,13,1382,90,169,259,False
2011-02-27,14,1383,105,177,282,False
2011-02-27,15,1384,98,163,261,False
2011-02-27,16,1385,98,170,268,False
2011-02-27,17,1386,66,121,187,False
2011-02-27,18,1387,24,103,127,False
2011-02-27,19,1388,16,86,102,False
2011-02-27,20,1389,9,72,81,False
2011-02-27,21,1390,8,61,69,False
2011-02-27,22,1391,2,67,69,False
2011-02-27,23,1392,6,53,59,False
2011-02-28,0,1393,5,25,30,False
2011-02-28,1,1394,1,7,8,False
2011-02-28,2,1395,5,18,23,True
2011-02-28,3,1396,0,1,1,False
2011-02-28,4,1397,1,5,6,True
2011-02-28,5,1398,1,4,5,False
2011-02-28,6,1399,1,27,28,False
2011-02-28,7,1400,2,90,92,False
2011-02-28,8,1401,13,242,255,False
2011-02-28,9,1402,15,127,142,False
2011-02-28,10,1403,13,79,92,False
2011-02-28,11,1404,13,74,87,False
2011-02-28,12,1405,0,36,36,False
2011-02-28,13,1406,1,31,32,False
2011-02-28,14,1407,1,24,25,False
2011-02-28,15,1408,0,35,35,False
2011-02-28,16,1409,2,40,42,False
2011-02-28,17,1410,2,77,79,False
2011-02-28,18,1411,4,127,131,False
2011-02-28,19,1412,1,79,80,False
2011-02-28,20,1413,0,45,45,False
2011-02-28,21,1414,2,78,80,False
2011-02-28,22,1415,4,72,76,False
2011-02-28,23,1416,0,45,45,False
2011-03-01,0,1417,0,7,7,False
2011-03-01,1,1418,0,3,3,False
2011-03-01,2,1419,0,4,4,False
2011-03-01,3,1420,0,2,2,False
2011-03-01,4,1421,0,1,1,False
2011-03-01,5,1422,1,1,2,False
2011-03-01,6,1423,0,46,46,False
2011-03-01,7,1424,2,105,107,False
2011-03-01,8,1425,10,204,214,False
2011-03-01,9,1426,8,116,124,False
2011-03-01,10,1427,13,55,68,False
2011-03-01,11,1428,8,48,56,False
2011-03-01,12,1429,6,80,86,False
2011-03-01,13,1430,13,65,78,False
2011-03-01,14,1431,18,61,79,False
2011-03-01,15,1432,7,57,64,False
2011-03-01,16,1433,10,92,102,False
2011-03-01,17,1434,12,230,242,False
2011-03-01,18,1435,10,214,224,False
2011-03-01,19,1436,4,115,119,False
2011-03-01,20,1437,2,86,88,False
2011-03-01,21,1438,8,55,63,False
2011-03-01,22,1439,3,44,47,False
2011-03-01,23,1440,2,23,25,False
2011-03-02,0,1441,3,5,8,False
2011-03-02,1,1442,0,4,4,False
2011-03-02,2,1443,0,2,2,False
2011-03-02,3,1444,3,1,4,False
2011-03-02,4,1445,1,0,1,False
2011-03-02,5,1446,0,5,5,False
2011-03-02,6,1447,1,39,40,False
2011-03-02,7,1448,2,108,110,False
2011-03-02,8,1449,13,243,256,False
2011-03-02,9,1450,7,141,148,False
2011-03-02,10,1451,11,65,76,False
2011-03-02,11,1452,8,65,73,False
2011-03-02,12,1453,20,62,82,False
2011-03-02,13,1454,35,90,125,False
2011-03-02,14,1455,21,75,96,False
2011-03-02,15,1456,19,91,110,False
2011-03-02,16,1457,27,112,139,False
2011-03-02,17,1458,30,238,268,False
2011-03-02,18,1459,8,193,201,False
2011-03-02,19,1460,6,144,150,False
2011-03-02,20,1461,9,86,95,False
2011-03-02,21,1462,3,68,71,False
2011-03-02,22,1463,4,44,48,False
2011-03-02,23,1464,0,22,22,False
2011-03-03,0,1465,3,10,13,False
2011-03-03,1,1466,0,1,1,False
2011-03-03,2,1467,1,2,3,False
2011-03-03,3,1468,0,1,1,False
2011-03-03,4,1469,0,1,1,False
2011-03-03,5,1470,1,7,8,False
2011-03-03,6,1471,1,34,35,False
2011-03-03,7,1472,1,110,111,False
2011-03-03,8,1473,4,216,220,False
2011-03-03,9,1474,10,135,145,False
2011-03-03,10,1475,7,49,56,False
2011-03-03,11,1476,10,40,50,False
2011-03-03,12,1477,7,65,72,False
2011-03-03,13,1478,13,67,80,False
2011-03-03,14,1479,18,60,78,False
2011-03-03,15,1480,6,62,68,False
2011-03-03,16,1481,6,65,71,False
2011-03-03,17,1482,17,185,202,False
2011-03-03,18,1483,6,161,167,False
2011-03-03,19,1484,5,101,106,False
2011-03-03,20,1485,1,69,70,False
2011-03-03,21,1486,3,48,51,False
2011-03-03,22,1487,3,50,53,False
2011-03-03,23,1488,0,23,23,False
2011-03-04,0,1489,0,12,12,False
2011-03-04,1,1490,0,4,4,False
2011-03-04,2,1491,0,2,2,False
2011-03-04,3,1492,0,1,1,False
2011-03-04,4,1493,1,0,1,False
2011-03-04,5,1494,0,7,7,False
2011-03-04,6,1495,1,28,29,False
2011-03-04,7,1496,0,83,83,False
2011-03-04,8,1497,6,222,228,False
2011-03-04,9,1498,12,138,150,False
2011-03-04,10,1499,10,56,66,False
2011-03-04,11,1500,16,73,89,False
2011-03-04,12,1501,10,87,97,False
2011-03-04,13,1502,13,74,87,False
2011-03-04,14,1503,30,65,95,False
2011-03-04,15,1504,31,75,106,False
2011-03-04,16,1505,17,101,118,False
2011-03-04,17,1506,22,206,228,False
2011-03-04,18,1507,15,172,187,False
2011-03-04,19,1508,5,102,107,False
2011-03-04,20,1509,9,78,87,False
2011-03-04,21,1510,6,64,70,False
2011-03-04,22,1511,4,40,44,False
2011-03-04,23,1512,6,40,46,False
2011-03-05,0,1513,4,15,19,False
2011-03-05,1,1514,5,20,25,False
2011-03-05,2,1515,5,15,20,False
2011-03-05,3,1516,0,2,2,False
2011-03-05,4,1517,0,1,1,False
2011-03-05,5,1518,0,3,3,False
2011-03-05,6,1519,1,3,4,False
2011-03-05,7,1520,5,10,15,False
2011-03-05,8,1521,11,34,45,False
2011-03-05,9,1522,15,48,63,False
2011-03-05,10,1523,34,69,103,False
2011-03-05,11,1524,43,116,159,False
2011-03-05,12,1525,46,121,167,False
2011-03-05,13,1526,60,130,190,False
2011-03-05,14,1527,80,118,198,False
2011-03-05,15,1528,83,122,205,False
2011-03-05,16,1529,74,130,204,False
2011-03-05,17,1530,60,104,164,False
2011-03-05,18,1531,37,115,152,False
2011-03-05,19,1532,27,62,89,False
2011-03-05,20,1533,12,58,70,False
2011-03-05,21,1534,12,60,72,False
2011-03-05,22,1535,16,47,63,False
2011-03-05,23,1536,10,34,44,False
2011-03-06,0,1537,11,41,52,False
2011-03-06,1,1538,12,27,39,False
2011-03-06,2,1539,5,27,32,False
2011-03-06,3,1540,2,9,11,False
2011-03-06,4,1541,0,3,3,False
2011-03-06,5,1542,1,18,19,True
2011-03-06,6,1543,1,1,2,False
2011-03-06,7,1544,0,5,5,False
2011-03-06,8,1545,1,8,9,False
2011-03-06,9,1546,4,18,22,False
2011-03-06,10,1547,4,27,31,False
2011-03-06,11,1548,18,44,62,False
2011-03-06,12,1549,10,69,79,False
2011-03-06,13,1550,22,83,105,False
2011-03-06,14,1551,12,27,39,False
2011-03-06,15,1552,3,4,7,False
2011-03-06,16,1553,3,8,11,False
2011-03-06,17,1554,2,23,25,False
2011-03-06,18,1555,0,23,23,False
2011-03-06,19,1556,0,11,11,False
2011-03-06,20,1557,3,8,11,False
2011-03-06,21,1558,1,6,7,False
2011-03-06,22,1559,0,10,10,False
2011-03-06,23,1560,0,9,9,False
2011-03-07,0,1561,0,4,4,False
2011-03-07,1,1562,0,2,2,False
2011-03-07,2,1563,5,18,23,True
2011-03-07,3,1564,0,1,1,False
2011-03-07,4,1565,1,0,1,False
2011-03-07,5,1566,0,1,1,False
2011-03-07,6,1567,3,31,34,False
2011-03-07,7,1568,3,88,91,False
2011-03-07,8,1569,11,200,211,False
2011-03-07,9,1570,5,129,134,False
2011-03-07,10,1571,15,43,58,False
2011-03-07,11,1572,19,41,60,False
2011-03-07,12,1573,28,68,96,False
2011-03-07,13,1574,16,54,70,False
2011-03-07,14,1575,21,56,77,False
2011-03-07,15,1576,32,64,96,False
2011-03-07,16,1577,26,96,122,False
2011-03-07,17,1578,27,206,233,False
2011-03-07,18,1579,19,214,233,False
2011-03-07,19,1580,11,134,145,False
2011-03-07,20,1581,5,87,92,False
2011-03-07,21,1582,1,53,54,False
2011-03-07,22,1583,1,34,35,False
2011-03-07,23,1584,0,22,22,False
2011-03-08,0,1585,1,9,10,False
2011-03-08,1,1586,0,4,4,False
2011-03-08,2,1587,1,0,1,False
2011-03-08,3,1588,5,2,7,False
2011-03-08,4,1589,0,2,2,False
2011-03-08,5,1590,2,8,10,False
2011-03-08,6,1591,3,42,45,False
2011-03-08,7,1592,9,119,128,False
2011-03-08,8,1593,10,247,257,False
2011-03-08,9,1594,11,140,151,False
2011-03-08,10,1595,25,46,71,False
2011-03-08,11,1596,26,52,78,False
2011-03-08,12,1597,29,70,99,False
2011-03-08,13,1598,25,73,98,False
2011-03-08,14,1599,16,56,72,False
2011-03-08,15,1600,35,77,112,False
2011-03-08,16,1601,26,82,108,False
2011-03-08,17,1602,39,209,248,False
2011-03-08,18,1603,21,214,235,False
2011-03-08,19,1604,9,141,150,False
2011-03-08,20,1605,2,74,76,False
2011-03-08,21,1606,7,68,75,False
2011-03-08,22,1607,11,44,55,False
2011-03-08,23,1608,3,38,41,False
2011-03-09,0,1609,0,9,9,False
2011-03-09,1,1610,0,4,4,False
2011-03-09,2,1611,1,1,2,False
2011-03-09,3,1612,1,2,3,False
2011-03-09,4,1613,0,2,2,False
2011-03-09,5,1614,1,7,8,False
2011-03-09,6,1615,5,44,49,False
2011-03-09,7,1616,18,123,141,False
2011-03-09,8,1617,11,238,249,False
2011-03-09,9,1618,5,136,141,False
2011-03-09,10,1619,8,49,57,False
2011-03-09,11,1620,15,44,59,False
2011-03-09,12,1621,14,84,98,False
2011-03-09,13,1622,17,82,99,False
2011-03-09,14,1623,10,61,71,False
2011-03-09,15,1624,15,64,79,False
2011-03-09,16,1625,10,102,112,False
2011-03-09,17,1626,18,176,194,False
2011-03-09,18,1627,12,176,188,False
2011-03-09,19,1628,11,123,134,False
2011-03-09,20,1629,4,87,91,False
2011-03-09,21,1630,10,52,62,False
2011-03-09,22,1631,4,17,21,False
2011-03-09,23,1632,1,17,18,False
2011-03-10,0,1633,3,0,3,False
2011-03-10,1,1634,0,2,2,False
2011-03-10,2,1635,0,1,1,False
2011-03-10,3,1636,3,9,12,True
2011-03-10,4,1637,1,5,6,True
2011-03-10,5,1638,1,2,3,False
2011-03-10,6,1639,0,12,12,False
2011-03-10,7,1640,1,36,37,False
2011-03-10,8,1641,1,43,44,False
2011-03-10,9,1642,1,23,24,False
2011-03-10,10,1643,0,17,17,False
2011-03-10,11,1644,6,5,11,False
2011-03-10,12,1645,4,30,34,False
2011-03-10,13,1646,1,11,12,False
2011-03-10,14,1647,0,12,12,False
2011-03-10,15,1648,3,11,14,False
2011-03-10,16,1649,1,20,21,False
2011-03-10,17,1650,2,109,111,False
2011-03-10,18,1651,2,80,82,False
2011-03-10,19,1652,5,51,56,False
2011-03-10,20,1653,9,29,38,False
2011-03-10,21,1654,1,27,28,False
2011-03-10,22,1655,4,30,34,False
2011-03-10,23,1656,1,26,27,False
2011-03-11,0,1657,0,6,6,False
2011-03-11,1,1658,0,8,8,False
2011-03-11,2,1659,2,3,5,False
2011-03-11,3,1660,0,2,2,False
2011-03-11,4,1661,1,5,6,True
2011-03-11,5,1662,1,6,7,False
2011-03-11,6,1663,1,31,32,False
2011-03-11,7,1664,10,104,114,False
2011-03-11,8,1665,15,244,259,False
2011-03-11,9,1666,13,143,156,False
2011-03-11,10,1667,18,60,78,False
2011-03-11,11,1668,14,67,81,False
2011-03-11,12,1669,15,96,111,False
2011-03-11,13,1670,15,92,107,False
2011-03-11,14,1671,25,64,89,False
2011-03-11,15,1672,21,64,85,False
2011-03-11,16,1673,18,95,113,False
2011-03-11,17,1674,23,200,223,False
2011-03-11,18,1675,19,134,153,False
2011-03-11,19,1676,7,111,118,False
2011-03-11,20,1677,6,70,76,False
2011-03-11,21,1678,10,43,53,False
2011-03-11,22,1679,11,53,64,False
2011-03-11,23,1680,3,34,37,False
2011-03-12,0,1681,4,30,34,False
2011-03-12,1,1682,3,15,18,False
2011-03-12,2,1683,0,14,14,False
2011-03-12,3,1684,1,6,7,False
2011-03-12,4,1685,0,1,1,False
2011-03-12,5,1686,0,2,2,False
2011-03-12,6,1687,2,2,4,False
2011-03-12,7,1688,4,19,23,False
2011-03-12,8,1689,9,44,53,False
2011-03-12,9,1690,25,76,101,False
2011-03-12,10,1691,21,78,99,False
2011-03-12,11,1692,36,83,119,False
2011-03-12,12,1693,51,107,158,False
2011-03-12,13,1694,62,95,157,False
2011-03-12,14,1695,70,96,166,False
2011-03-12,15,1696,81,101,182,False
2011-03-12,16,1697,100,144,244,False
2011-03-12,17,1698,99,114,213,False
2011-03-12,18,1699,54,91,145,False
2011-03-12,19,1700,26,86,112,False
2011-03-12,20,1701,22,64,86,False
2011-03-12,21,1702,36,46,82,False
2011-03-12,22,1703,7,56,63,False
2011-03-12,23,1704,11,38,49,False
2011-03-13,0,1705,3,35,38,False
2011-03-13,1,1706,10,23,33,False
2011-03-13,2,1707,5,18,23,True
2011-03-13,3,1708,6,17,23,False
2011-03-13,4,1709,4,9,13,False
2011-03-13,5,1710,0,3,3,False
2011-03-13,6,1711,0,2,2,False
2011-03-13,7,1712,2,8,10,False
2011-03-13,8,1713,11,23,34,False
2011-03-13,9,1714,8,36,44,False
2011-03-13,10,1715,36,86,122,False
2011-03-13,11,1716,88,93,181,False
2011-03-13,12,1717,74,120,194,False
2011-03-13,13,1718,97,124,221,False
2011-03-13,14,1719,144,106,250,False
2011-03-13,15,1720,149,155,304,False
2011-03-13,16,1721,124,132,256,False
2011-03-13,17,1722,98,143,241,False
2011-03-13,18,1723,55,92,147,False
2011-03-13,19,1724,28,73,101,False
2011-03-13,20,1725,23,54,77,False
2011-03-13,21,1726,9,49,58,False
2011-03-13,22,1727,8,29,37,False
2011-03-13,23,1728,5,23,28,False
2011-03-14,0,1729,4,7,11,False
2011-03-14,1,1730,0,1,1,False
2011-03-14,2,1731,0,1,1,False
2011-03-14,3,1732,0,3,3,False
2011-03-14,4,1733,1,5,6,True
2011-03-14,5,1734,0,8,8,False
2011-03-14,6,1735,1,27,28,False
2011-03-14,7,1736,4,84,88,False
2011-03-14,8,1737,24,217,241,False
2011-03-14,9,1738,13,127,140,False
2011-03-14,10,1739,27,57,84,False
2011-03-14,11,1740,26,45,71,False
2011-03-14,12,1741,40,54,94,False
2011-03-14,13,1742,24,51,75,False
2011-03-14,14,1743,27,52,79,False
2011-03-14,15,1744,24,77,101,False
2011-03-14,16,1745,27,80,107,False
2011-03-14,17,1746,42,229,271,False
2011-03-14,18,1747,25,210,235,False
2011-03-14,19,1748,17,133,150,False
2011-03-14,20,1749,23,106,129,False
2011-03-14,21,1750,5,58,63,False
2011-03-14,22,1751,4,43,47,False
2011-03-14,23,1752,2,17,19,False
2011-03-15,0,1753,7,7,14,False
2011-03-15,1,1754,4,6,10,False
2011-03-15,2,1755,1,2,3,False
2011-03-15,3,1756,3,9,12,True
2011-03-15,4,1757,1,1,2,False
2011-03-15,5,1758,0,11,11,False
2011-03-15,6,1759,3,32,35,False
2011-03-15,7,1760,10,109,119,False
2011-03-15,8,1761,23,259,282,False
2011-03-15,9,1762,10,147,157,False
2011-03-15,10,1763,22,56,78,False
2011-03-15,11,1764,27,51,78,False
2011-03-15,12,1765,32,70,102,False
2011-03-15,13,1766,23,74,97,False
2011-03-15,14,1767,14,74,88,False
2011-03-15,15,1768,24,66,90,False
2011-03-15,16,1769,21,93,114,False
2011-03-15,17,1770,22,195,217,False
2011-03-15,18,1771,18,207,225,False
2011-03-15,19,1772,14,138,152,False
2011-03-15,20,1773,9,79,88,False
2011-03-15,21,1774,2,53,55,False
2011-03-15,22,1775,1,20,21,False
2011-03-15,23,1776,1,17,18,False
2011-03-16,0,1777,0,8,8,False
2011-03-16,1,1778,1,2,3,False
2011-03-16,2,1779,5,18,23,True
2011-03-16,3,1780,1,2,3,False
2011-03-16,4,1781,0,1,1,False
2011-03-16,5,1782,0,3,3,False
2011-03-16,6,1783,1,30,31,False
2011-03-16,7,1784,10,101,111,False
2011-03-16,8,1785,26,227,253,False
2011-03-16,9,1786,10,144,154,False
2011-03-16,10,1787,19,49,68,False
2011-03-16,11,1788,13,62,75,False
2011-03-16,12,1789,23,65,88,False
2011-03-16,13,1790,18,81,99,False
2011-03-16,14,1791,33,67,100,False
2011-03-16,15,1792,22,79,101,False
2011-03-16,16,1793,30,121,151,False
2011-03-16,17,1794,37,216,253,False
2011-03-16,18,1795,26,211,237,False
2011-03-16,19,1796,18,150,168,False
2011-03-16,20,1797,10,111,121,False
2011-03-16,21,1798,3,75,78,False
2011-03-16,22,1799,11,48,59,False
2011-03-16,23,1800,9,18,27,False
2011-03-17,0,1801,4,19,23,False
2011-03-17,1,1802,1,11,12,False
2011-03-17,2,1803,3,5,8,False
2011-03-17,3,1804,1,1,2,False
2011-03-17,4,1805,0,3,3,False
2011-03-17,5,1806,0,13,13,False
2011-03-17,6,1807,4,47,51,False
2011-03-17,7,1808,12,128,140,False
2011-03-17,8,1809,17,282,299,False
2011-03-17,9,1810,23,162,185,False
2011-03-17,10,1811,9,69,78,False
2011-03-17,11,1812,20,66,86,False
2011-03-17,12,1813,24,81,105,False
2011-03-17,13,1814,26,85,111,False
2011-03-17,14,1815,32,87,119,False
2011-03-17,15,1816,30,95,125,False
2011-03-17,16,1817,34,108,142,False
2011-03-17,17,1818,48,265,313,False
2011-03-17,18,1819,50,260,310,False
2011-03-17,19,1820,18,189,207,False
2011-03-17,20,1821,25,112,137,False
2011-03-17,21,1822,19,119,138,False
2011-03-17,22,1823,17,70,87,False
2011-03-17,23,1824,7,43,50,False
2011-03-18,0,1825,5,24,29,False
2011-03-18,1,1826,4,12,16,False
2011-03-18,2,1827,5,9,14,False
2011-03-18,3,1828,1,4,5,False
2011-03-18,4,1829,1,5,6,True
2011-03-18,5,1830,2,8,10,False
2011-03-18,6,1831,1,35,36,False
2011-03-18,7,1832,11,112,123,False
2011-03-18,8,1833,24,256,280,False
2011-03-18,9,1834,18,192,210,False
2011-03-18,10,1835,43,74,117,False
2011-03-18,11,1836,55,104,159,False
2011-03-18,12,1837,72,123,195,False
2011-03-18,13,1838,57,118,175,False
2011-03-18,14,1839,71,103,174,False
2011-03-18,15,1840,62,111,173,False
2011-03-18,16,1841,67,137,204,False
2011-03-18,17,1842,95,237,332,False
2011-03-18,18,1843,84,247,331,False
2011-03-18,19,1844,58,132,190,False
2011-03-18,20,1845,46,103,149,False
2011-03-18,21,1846,22,91,113,False
2011-03-18,22,1847,55,63,118,False
2011-03-18,23,1848,26,60,86,False
2011-03-19,0,1849,26,50,76,False
2011-03-19,1,1850,16,35,51,False
2011-03-19,2,1851,5,20,25,False
2011-03-19,3,1852,1,7,8,False
2011-03-19,4,1853,1,2,3,False
2011-03-19,5,1854,0,2,2,False
2011-03-19,6,1855,0,10,10,False
2011-03-19,7,1856,4,9,13,False
2011-03-19,8,1857,11,37,48,False
2011-03-19,9,1858,35,41,76,False
2011-03-19,10,1859,55,85,140,False
2011-03-19,11,1860,90,106,196,False
2011-03-19,12,1861,126,141,267,False
2011-03-19,13,1862,174,127,301,False
2011-03-19,14,1863,168,144,312,False
2011-03-19,15,1864,170,143,313,False
2011-03-19,16,1865,175,129,304,False
2011-03-19,17,1866,138,140,278,False
2011-03-19,18,1867,92,125,217,False
2011-03-19,19,1868,38,116,154,False
2011-03-19,20,1869,39,69,108,False
2011-03-19,21,1870,20,73,93,False
2011-03-19,22,1871,27,45,72,False
2011-03-19,23,1872,13,37,50,False
2011-03-20,0,1873,7,33,40,False
2011-03-20,1,1874,2,22,24,False
2011-03-20,2,1875,6,24,30,False
2011-03-20,3,1876,1,11,12,False
2011-03-20,4,1877,2,1,3,False
2011-03-20,5,1878,3,6,9,False
2011-03-20,6,1879,1,3,4,False
2011-03-20,7,1880,5,9,14,False
2011-03-20,8,1881,7,30,37,False
2011-03-20,9,1882,35,43,78,False
2011-03-20,10,1883,55,81,136,False
2011-03-20,11,1884,92,111,203,False
2011-03-20,12,1885,120,108,228,False
2011-03-20,13,1886,88,115,203,False
2011-03-20,14,1887,145,134,279,False
2011-03-20,15,1888,172,136,308,False
2011-03-20,16,1889,92,132,224,False
2011-03-20,17,1890,83,143,226,False
2011-03-20,18,1891,58,98,156,False
2011-03-20,19,1892,21,58,79,False
2011-03-20,20,1893,21,46,67,False
2011-03-20,21,1894,10,39,49,False
2011-03-20,22,1895,8,30,38,False
2011-03-20,23,1896,13,11,24,False
2011-03-21,0,1897,2,11,13,False
2011-03-21,1,1898,1,6,7,False
2011-03-21,2,1899,1,5,6,False
2011-03-21,3,1900,0,1,1,False
2011-03-21,4,1901,1,5,6,True
2011-03-21,5,1902,1,1,2,False
2011-03-21,6,1903,2,30,32,False
2011-03-21,7,1904,3,15,18,False
2011-03-21,8,1905,3,95,98,False
2011-03-21,9,1906,12,115,127,False
2011-03-21,10,1907,17,45,62,False
2011-03-21,11,1908,32,47,79,False
2011-03-21,12,1909,25,56,81,False
2011-03-21,13,1910,35,77,112,False
2011-03-21,14,1911,36,65,101,False
2011-03-21,15,1912,41,66,107,False
2011-03-21,16,1913,29,112,141,False
2011-03-21,17,1914,41,231,272,False
2011-03-21,18,1915,44,232,276,False
2011-03-21,19,1916,22,199,221,False
2011-03-21,20,1917,16,106,122,False
2011-03-21,21,1918,12,79,91,False
2011-03-21,22,1919,18,60,78,False
2011-03-21,23,1920,8,22,30,False
2011-03-22,0,1921,4,7,11,False
2011-03-22,1,1922,6,13,19,False
2011-03-22,2,1923,0,1,1,False
2011-03-22,3,1924,3,2,5,False
2011-03-22,4,1925,0,1,1,False
2011-03-22,5,1926,1,11,12,False
2011-03-22,6,1927,2,58,60,False
2011-03-22,7,1928,4,132,136,False
2011-03-22,8,1929,24,312,336,False
2011-03-22,9,1930,19,159,178,False
2011-03-22,10,1931,29,95,124,False
2011-03-22,11,1932,22,64,86,False
2011-03-22,12,1933,35,86,121,False
2011-03-22,13,1934,21,85,106,False
2011-03-22,14,1935,30,71,101,False
2011-03-22,15,1936,55,79,134,False
2011-03-22,16,1937,40,125,165,False
2011-03-22,17,1938,42,265,307,False
2011-03-22,18,1939,41,271,312,False
2011-03-22,19,1940,22,142,164,False
2011-03-22,20,1941,19,116,135,False
2011-03-22,21,1942,24,63,87,False
2011-03-22,22,1943,13,57,70,False
2011-03-22,23,1944,4,28,32,False
2011-03-23,0,1945,3,8,11,False
2011-03-23,1,1946,0,7,7,False
2011-03-23,2,1947,1,1,2,False
2011-03-23,3,1948,0,3,3,False
2011-03-23,4,1949,1,5,6,True
2011-03-23,5,1950,0,10,10,False
2011-03-23,6,1951,1,43,44,False
2011-03-23,7,1952,7,111,118,False
2011-03-23,8,1953,14,247,261,False
2011-03-23,9,1954,8,174,182,False
2011-03-23,10,1955,15,60,75,False
2011-03-23,11,1956,18,53,71,False
2011-03-23,12,1957,14,73,87,False
2011-03-23,13,1958,14,94,108,False
2011-03-23,14,1959,13,71,84,False
2011-03-23,15,1960,11,74,85,False
2011-03-23,16,1961,13,123,136,False
2011-03-23,17,1962,28,245,273,False
2011-03-23,18,1963,20,218,238,False
2011-03-23,19,1964,12,147,159,False
2011-03-23,20,1965,3,72,75,False
2011-03-23,21,1966,0,22,22,False
2011-03-23,22,1967,6,38,44,False
2011-03-23,23,1968,2,24,26,False
2011-03-24,0,1969,0,11,11,False
2011-03-24,1,1970,0,3,3,False
2011-03-24,2,1971,0,6,6,False
2011-03-24,3,1972,1,0,1,False
2011-03-24,4,1973,0,1,1,False
2011-03-24,5,1974,1,8,9,False
2011-03-24,6,1975,0,41,41,False
2011-03-24,7,1976,2,106,108,False
2011-03-24,8,1977,4,120,124,False
2011-03-24,9,1978,3,94,97,False
2011-03-24,10,1979,10,55,65,False
2011-03-24,11,1980,10,61,71,False
2011-03-24,12,1981,12,82,94,False
2011-03-24,13,1982,11,90,101,False
2011-03-24,14,1983,17,66,83,False
2011-03-24,15,1984,13,77,90,False
2011-03-24,16,1985,6,78,84,False
2011-03-24,17,1986,12,221,233,False
2011-03-24,18,1987,17,197,214,False
2011-03-24,19,1988,16,122,138,False
2011-03-24,20,1989,8,110,118,False
2011-03-24,21,1990,11,67,78,False
2011-03-24,22,1991,3,59,62,False
2011-03-24,23,1992,9,24,33,False
2011-03-25,0,1993,1,17,18,False
2011-03-25,1,1994,0,5,5,False
2011-03-25,2,1995,0,5,5,False
2011-03-25,3,1996,0,2,2,False
2011-03-25,4,1997,3,2,5,False
2011-03-25,5,1998,0,9,9,False
2011-03-25,6,1999,0,32,32,False
2011-03-25,7,2000,4,100,104,False
2011-03-25,8,2001,9,228,237,False
2011-03-25,9,2002,16,150,166,False
2011-03-25,10,2003,15,53,68,False
2011-03-25,11,2004,17,58,75,False
2011-03-25,12,2005,37,108,145,False
2011-03-25,13,2006,34,104,138,False
2011-03-25,14,2007,30,103,133,False
2011-03-25,15,2008,43,79,122,False
2011-03-25,16,2009,23,127,150,False
2011-03-25,17,2010,23,202,225,False
2011-03-25,18,2011,8,190,198,False
2011-03-25,19,2012,9,126,135,False
2011-03-25,20,2013,6,75,81,False
2011-03-25,21,2014,11,64,75,False
2011-03-25,22,2015,3,40,43,False
2011-03-25,23,2016,8,31,39,False
2011-03-26,0,2017,3,25,28,False
2011-03-26,1,2018,3,24,27,False
2011-03-26,2,2019,4,21,25,False
2011-03-26,3,2020,2,7,9,False
2011-03-26,4,2021,2,4,6,False
2011-03-26,5,2022,0,8,8,False
2011-03-26,6,2023,2,8,10,False
2011-03-26,7,2024,18,23,41,False
2011-03-26,8,2025,24,42,66,False
2011-03-26,9,2026,32,68,100,False
2011-03-26,10,2027,32,93,125,False
2011-03-26,11,2028,75,93,168,False
2011-03-26,12,2029,98,129,227,False
2011-03-26,13,2030,94,145,239,False
2011-03-26,14,2031,93,123,216,False
2011-03-26,15,2032,110,109,219,False
2011-03-26,16,2033,118,130,248,False
2011-03-26,17,2034,102,101,203,False
2011-03-26,18,2035,64,89,153,False
2011-03-26,19,2036,45,93,138,False
2011-03-26,20,2037,18,67,85,False
2011-03-26,21,2038,15,36,51,False
2011-03-26,22,2039,17,46,63,False
2011-03-26,23,2040,10,31,41,False
2011-03-27,0,2041,5,26,31,False
2011-03-27,1,2042,3,17,20,False
2011-03-27,2,2043,6,15,21,False
2011-03-27,3,2044,0,14,14,False
2011-03-27,4,2045,1,5,6,False
2011-03-27,5,2046,1,18,19,True
2011-03-27,6,2047,0,2,2,False
2011-03-27,7,2048,0,7,7,False
2011-03-27,8,2049,6,8,14,False
2011-03-27,9,2050,17,37,54,False
2011-03-27,10,2051,27,59,86,False
2011-03-27,11,2052,23,85,108,False
2011-03-27,12,2053,43,120,163,False
2011-03-27,13,2054,47,100,147,False
2011-03-27,14,2055,61,103,164,False
2011-03-27,15,2056,61,111,172,False
2011-03-27,16,2057,45,98,143,False
2011-03-27,17,2058,50,109,159,False
2011-03-27,18,2059,32,105,137,False
2011-03-27,19,2060,23,80,103,False
2011-03-27,20,2061,7,50,57,False
2011-03-27,21,2062,7,29,36,False
2011-03-27,22,2063,5,25,30,False
2011-03-27,23,2064,3,16,19,False
2011-03-28,0,2065,1,11,12,False
2011-03-28,1,2066,2,4,6,False
2011-03-28,2,2067,0,5,5,False
2011-03-28,3,2068,0,2,2,False
2011-03-28,4,2069,1,5,6,True
2011-03-28,5,2070,0,8,8,False
2011-03-28,6,2071,0,40,40,False
2011-03-28,7,2072,6,104,110,False
2011-03-28,8,2073,15,239,254,False
2011-03-28,9,2074,12,109,121,False
2011-03-28,10,2075,22,47,69,False
2011-03-28,11,2076,18,39,57,False
2011-03-28,12,2077,8,71,79,False
2011-03-28,13,2078,14,69,83,False
2011-03-28,14,2079,15,65,80,False
2011-03-28,15,2080,19,53,72,False
2011-03-28,16,2081,15,117,132,False
2011-03-28,17,2082,25,227,252,False
2011-03-28,18,2083,21,220,241,False
2011-03-28,19,2084,17,156,173,False
2011-03-28,20,2085,5,107,112,False
2011-03-28,21,2086,6,55,61,False
2011-03-28,22,2087,0,40,40,False
2011-03-28,23,2088,1,18,19,False
2011-03-29,0,2089,1,15,16,False
2011-03-29,1,2090,0,4,4,False
2011-03-29,2,2091,0,3,3,False
2011-03-29,3,2092,2,1,3,False
2011-03-29,4,2093,1,1,2,False
2011-03-29,5,2094,0,8,8,False
2011-03-29,6,2095,4,46,50,False
2011-03-29,7,2096,5,128,133,False
2011-03-29,8,2097,19,268,287,False
2011-03-29,9,2098,16,156,172,False
2011-03-29,10,2099,13,46,59,False
2011-03-29,11,2100,18,63,81,False
2011-03-29,12,2101,29,77,106,False
2011-03-29,13,2102,24,80,104,False
2011-03-29,14,2103,20,66,86,False
2011-03-29,15,2104,22,65,87,False
2011-03-29,16,2105,12,124,136,False
2011-03-29,17,2106,34,265,299,False
2011-03-29,18,2107,42,252,294,False
2011-03-29,19,2108,20,170,190,False
2011-03-29,20,2109,13,119,132,False
2011-03-29,21,2110,8,75,83,False
2011-03-29,22,2111,6,49,55,False
2011-03-29,23,2112,8,27,35,False
2011-03-30,0,2113,3,8,11,False
2011-03-30,1,2114,1,9,10,False
2011-03-30,2,2115,0,4,4,False
2011-03-30,3,2116,0,4,4,False
2011-03-30,4,2117,1,0,1,False
2011-03-30,5,2118,0,7,7,False
2011-03-30,6,2119,4,44,48,False
2011-03-30,7,2120,8,128,136,False
2011-03-30,8,2121,16,247,263,False
2011-03-30,9,2122,7,147,154,False
2011-03-30,10,2123,13,51,64,False
2011-03-30,11,2124,26,64,90,False
2011-03-30,12,2125,15,65,80,False
2011-03-30,13,2126,14,84,98,False
2011-03-30,14,2127,16,64,80,False
2011-03-30,15,2128,14,56,70,False
2011-03-30,16,2129,0,36,36,False
2011-03-30,17,2130,11,105,116,False
2011-03-30,18,2131,6,79,85,False
2011-03-30,19,2132,5,67,72,False
2011-03-30,20,2133,4,40,44,False
2011-03-30,21,2134,0,27,27,False
2011-03-30,22,2135,3,21,24,False
2011-03-30,23,2136,1,11,12,False
2011-03-31,0,2137,0,3,3,False
2011-03-31,1,2138,1,4,5,False
2011-03-31,2,2139,0,5,5,False
2011-03-31,3,2140,0,1,1,False
2011-03-31,4,2141,0,2,2,False
2011-03-31,5,2142,0,8,8,False
2011-03-31,6,2143,2,34,36,False
2011-03-31,7,2144,5,87,92,False
2011-03-31,8,2145,7,185,192,False
2011-03-31,9,2146,6,126,132,False
2011-03-31,10,2147,15,54,69,False
2011-03-31,11,2148,6,52,58,False
2011-03-31,12,2149,17,73,90,False
2011-03-31,13,2150,13,55,68,False
2011-03-31,14,2151,27,49,76,False
2011-03-31,15,2152,4,61,65,False
2011-03-31,16,2153,13,72,85,False
2011-03-31,17,2154,15,153,168,False
2011-03-31,18,2155,12,165,177,False
2011-03-31,19,2156,12,118,130,False
2011-03-31,20,2157,6,79,85,False
2011-03-31,21,2158,7,53,60,False
2011-03-31,22,2159,7,44,51,False
2011-03-31,23,2160,4,23,27,False
2011-04-01,0,2161,0,6,6,False
2011-04-01,1,2162,0,4,4,False
2011-04-01,2,2163,0,7,7,False
2011-04-01,3,2164,0,4,4,False
2011-04-01,4,2165,0,3,3,False
2011-04-01,5,2166,1,11,12,False
2011-04-01,6,2167,2,26,28,False
2011-04-01,7,2168,4,91,95,False
2011-04-01,8,2169,8,198,206,False
2011-04-01,9,2170,11,162,173,False
2011-04-01,10,2171,12,63,75,False
2011-04-01,11,2172,17,72,89,False
2011-04-01,12,2173,15,80,95,False
2011-04-01,13,2174,18,92,110,False
2011-04-01,14,2175,26,61,87,False
2011-04-01,15,2176,30,81,111,False
2011-04-01,16,2177,42,125,167,False
2011-04-01,17,2178,36,245,281,False
2011-04-01,18,2179,36,205,241,False
2011-04-01,19,2180,16,120,136,False
2011-04-01,20,2181,2,75,77,False
2011-04-01,21,2182,9,84,93,False
2011-04-01,22,2183,10,64,74,False
2011-04-01,23,2184,12,41,53,False
2011-04-02,0,2185,3,29,32,False
2011-04-02,1,2186,4,28,32,False
2011-04-02,2,2187,1,20,21,False
2011-04-02,3,2188,1,8,9,False
2011-04-02,4,2189,0,5,5,False
2011-04-02,5,2190,1,4,5,False
2011-04-02,6,2191,5,7,12,False
2011-04-02,7,2192,2,16,18,False
2011-04-02,8,2193,10,45,55,False
2011-04-02,9,2194,22,65,87,False
2011-04-02,10,2195,41,113,154,False
2011-04-02,11,2196,72,126,198,False
2011-04-02,12,2197,84,100,184,False
2011-04-02,13,2198,56,81,137,False
2011-04-02,14,2199,97,93,190,False
2011-04-02,15,2200,72,64,136,False
2011-04-02,16,2201,111,85,196,False
2011-04-02,17,2202,89,95,184,False
2011-04-02,18,2203,69,110,179,False
2011-04-02,19,2204,71,77,148,False
2011-04-02,20,2205,29,56,85,False
2011-04-02,21,2206,24,53,77,False
2011-04-02,22,2207,14,41,55,False
2011-04-02,23,2208,20,33,53,False
2011-04-03,0,2209,8,31,39,False
2011-04-03,1,2210,8,26,34,False
2011-04-03,2,2211,5,19,24,False
2011-04-03,3,2212,3,8,11,False
2011-04-03,4,2213,3,0,3,False
2011-04-03,5,2214,1,4,5,False
2011-04-03,6,2215,10,23,33,False
2011-04-03,7,2216,13,20,33,False
2011-04-03,8,2217,18,44,62,False
2011-04-03,9,2218,68,74,142,False
2011-04-03,10,2219,111,104,215,False
2011-04-03,11,2220,139,104,243,False
2011-04-03,12,2221,166,147,313,False
2011-04-03,13,2222,219,148,367,False
2011-04-03,14,2223,240,109,349,False
2011-04-03,15,2224,174,118,292,False
2011-04-03,16,2225,147,156,303,False
2011-04-03,17,2226,148,126,274,False
2011-04-03,18,2227,71,101,172,False
2011-04-03,19,2228,51,93,144,False
2011-04-03,20,2229,24,55,79,False
2011-04-03,21,2230,8,37,45,False
2011-04-03,22,2231,7,29,36,False
2011-04-03,23,2232,9,22,31,False
2011-04-04,0,2233,1,5,6,False
2011-04-04,1,2234,7,4,11,False
2011-04-04,2,2235,1,1,2,False
2011-04-04,3,2236,1,0,1,False
2011-04-04,4,2237,1,1,2,False
2011-04-04,5,2238,0,7,7,False
2011-04-04,6,2239,3,43,46,False
2011-04-04,7,2240,7,150,157,False
2011-04-04,8,2241,31,308,339,False
2011-04-04,9,2242,24,134,158,False
2011-04-04,10,2243,35,55,90,False
2011-04-04,11,2244,58,66,124,False
2011-04-04,12,2245,59,98,157,False
2011-04-04,13,2246,47,92,139,False
2011-04-04,14,2247,47,76,123,False
2011-04-04,15,2248,47,96,143,False
2011-04-04,16,2249,59,130,189,False
2011-04-04,17,2250,83,283,366,False
2011-04-04,18,2251,78,308,386,False
2011-04-04,19,2252,51,227,278,False
2011-04-04,20,2253,40,133,173,False
2011-04-04,21,2254,19,76,95,False
2011-04-04,22,2255,17,58,75,False
2011-04-04,23,2256,18,30,48,False
2011-04-05,0,2257,10,12,22,False
2011-04-05,1,2258,10,5,15,False
2011-04-05,2,2259,0,5,5,False
2011-04-05,3,2260,1,3,4,False
2011-04-05,4,2261,0,2,2,False
2011-04-05,5,2262,0,5,5,False
2011-04-05,6,2263,2,36,38,False
2011-04-05,7,2264,10,124,134,False
2011-04-05,8,2265,9,148,157,False
2011-04-05,9,2266,2,44,46,False
2011-04-05,10,2267,3,25,28,False
2011-04-05,11,2268,1,18,19,False
2011-04-05,12,2269,6,32,38,False
2011-04-05,13,2270,5,51,56,False
2011-04-05,14,2271,9,67,76,False
2011-04-05,15,2272,6,62,68,False
2011-04-05,16,2273,17,113,130,False
2011-04-05,17,2274,27,246,273,False
2011-04-05,18,2275,19,248,267,False
2011-04-05,19,2276,12,148,160,False
2011-04-05,20,2277,4,87,91,False
2011-04-05,21,2278,8,81,89,False
2011-04-05,22,2279,3,43,46,False
2011-04-05,23,2280,3,23,26,False
2011-04-06,0,2281,0,15,15,False
2011-04-06,1,2282,0,2,2,False
2011-04-06,2,2283,0,5,5,False
2011-04-06,3,2284,0,4,4,False
2011-04-06,4,2285,0,1,1,False
2011-04-06,5,2286,1,12,13,False
2011-04-06,6,2287,4,52,56,False
2011-04-06,7,2288,3,130,133,False
2011-04-06,8,2289,17,308,325,False
2011-04-06,9,2290,8,157,165,False
2011-04-06,10,2291,21,48,69,False
2011-04-06,11,2292,23,70,93,False
2011-04-06,12,2293,22,112,134,False
2011-04-06,13,2294,29,83,112,False
2011-04-06,14,2295,35,80,115,False
2011-04-06,15,2296,34,83,117,False
2011-04-06,16,2297,27,142,169,False
2011-04-06,17,2298,53,303,356,False
2011-04-06,18,2299,43,282,325,False
2011-04-06,19,2300,36,196,232,False
2011-04-06,20,2301,15,126,141,False
2011-04-06,21,2302,18,84,102,False
2011-04-06,22,2303,13,71,84,False
2011-04-06,23,2304,11,29,40,False
2011-04-07,0,2305,5,15,20,False
2011-04-07,1,2306,2,11,13,False
2011-04-07,2,2307,0,7,7,False
2011-04-07,3,2308,0,3,3,False
2011-04-07,4,2309,0,1,1,False
2011-04-07,5,2310,0,6,6,False
2011-04-07,6,2311,5,59,64,False
2011-04-07,7,2312,8,152,160,False
2011-04-07,8,2313,23,291,314,False
2011-04-07,9,2314,15,155,170,False
2011-04-07,10,2315,29,66,95,False
2011-04-07,11,2316,36,86,122,False
2011-04-07,12,2317,39,114,153,False
2011-04-07,13,2318,36,99,135,False
2011-04-07,14,2319,46,111,157,False
2011-04-07,15,2320,27,133,160,False
2011-04-07,16,2321,52,161,213,False
2011-04-07,17,2322,63,280,343,False
2011-04-07,18,2323,68,265,333,False
2011-04-07,19,2324,34,192,226,False
2011-04-07,20,2325,37,166,203,False
2011-04-07,21,2326,19,89,108,False
2011-04-07,22,2327,18,63,81,False
2011-04-07,23,2328,9,45,54,False
2011-04-08,0,2329,4,21,25,False
2011-04-08,1,2330,3,6,9,False
2011-04-08,2,2331,3,10,13,False
2011-04-08,3,2332,0,1,1,False
2011-04-08,4,2333,0,1,1,False
2011-04-08,5,2334,1,8,9,False
2011-04-08,6,2335,2,33,35,False
2011-04-08,7,2336,4,109,113,False
2011-04-08,8,2337,13,208,221,False
2011-04-08,9,2338,17,168,185,False
2011-04-08,10,2339,10,63,73,False
2011-04-08,11,2340,19,79,98,False
2011-04-08,12,2341,29,51,80,False
2011-04-08,13,2342,7,35,42,False
2011-04-08,14,2343,2,13,15,False
2011-04-08,15,2344,1,24,25,False
2011-04-08,16,2345,2,58,60,False
2011-04-08,17,2346,10,138,148,False
2011-04-08,18,2347,8,54,62,False
2011-04-08,19,2348,1,52,53,False
2011-04-08,20,2349,12,51,63,False
2011-04-08,21,2350,11,43,54,False
2011-04-08,22,2351,9,42,51,False
2011-04-08,23,2352,4,31,35,False
2011-04-09,0,2353,5,26,31,False
2011-04-09,1,2354,3,17,20,False
2011-04-09,2,2355,2,15,17,False
2011-04-09,3,2356,3,11,14,False
2011-04-09,4,2357,0,3,3,False
2011-04-09,5,2358,0,5,5,False
2011-04-09,6,2359,0,13,13,False
2011-04-09,7,2360,8,13,21,False
2011-04-09,8,2361,7,47,54,False
2011-04-09,9,2362,27,71,98,False
2011-04-09,10,2363,43,90,133,False
2011-04-09,11,2364,51,91,142,False
2011-04-09,12,2365,79,123,202,False
2011-04-09,13,2366,114,108,222,False
2011-04-09,14,2367,94,118,212,False
2011-04-09,15,2368,85,116,201,False
2011-04-09,16,2369,73,118,191,False
2011-04-09,17,2370,128,129,257,False
2011-04-09,18,2371,48,129,177,False
2011-04-09,19,2372,47,83,130,False
2011-04-09,20,2373,19,74,93,False
2011-04-09,21,2374,10,65,75,False
2011-04-09,22,2375,21,66,87,False
2011-04-09,23,2376,12,45,57,False
2011-04-10,0,2377,5,48,53,False
2011-04-10,1,2378,6,31,37,False
2011-04-10,2,2379,12,24,36,False
2011-04-10,3,2380,5,11,16,False
2011-04-10,4,2381,3,2,5,False
2011-04-10,5,2382,0,4,4,False
2011-04-10,6,2383,0,4,4,False
2011-04-10,7,2384,3,7,10,False
2011-04-10,8,2385,17,38,55,False
2011-04-10,9,2386,31,50,81,False
2011-04-10,10,2387,69,81,150,False
2011-04-10,11,2388,93,109,202,False
2011-04-10,12,2389,94,136,230,False
2011-04-10,13,2390,121,142,263,False
2011-04-10,14,2391,148,133,281,False
2011-04-10,15,2392,156,141,297,False
2011-04-10,16,2393,135,153,288,False
2011-04-10,17,2394,84,152,236,False
2011-04-10,18,2395,103,137,240,False
2011-04-10,19,2396,47,84,131,False
2011-04-10,20,2397,21,71,92,False
2011-04-10,21,2398,18,77,95,False
2011-04-10,22,2399,12,45,57,False
2011-04-10,23,2400,5,27,32,False
2011-04-11,0,2401,7,16,23,False
2011-04-11,1,2402,1,3,4,False
2011-04-11,2,2403,7,2,9,False
2011-04-11,3,2404,3,9,12,True
2011-04-11,4,2405,0,1,1,False
2011-04-11,5,2406,1,12,13,False
2011-04-11,6,2407,2,59,61,False
2011-04-11,7,2408,12,164,176,False
2011-04-11,8,2409,28,286,314,False
2011-04-11,9,2410,33,132,165,False
2011-04-11,10,2411,41,55,96,False
2011-04-11,11,2412,45,59,104,False
2011-04-11,12,2413,37,97,134,False
2011-04-11,13,2414,62,77,139,False
2011-04-11,14,2415,60,85,145,False
2011-04-11,15,2416,56,85,141,False
2011-04-11,16,2417,73,162,235,False
2011-04-11,17,2418,100,352,452,False
2011-04-11,18,2419,93,290,383,False
2011-04-11,19,2420,73,211,284,False
2011-04-11,20,2421,44,122,166,False
2011-04-11,21,2422,39,119,158,False
2011-04-11,22,2423,25,66,91,False
2011-04-11,23,2424,16,38,54,False
2011-04-12,0,2425,11,13,24,False
2011-04-12,1,2426,6,7,13,False
2011-04-12,2,2427,7,7,14,False
2011-04-12,3,2428,0,1,1,False
2011-04-12,4,2429,4,2,6,False
2011-04-12,5,2430,1,15,16,False
2011-04-12,6,2431,3,55,58,False
2011-04-12,7,2432,12,177,189,False
2011-04-12,8,2433,15,211,226,False
2011-04-12,9,2434,4,50,54,False
2011-04-12,10,2435,6,34,40,False
2011-04-12,11,2436,11,38,49,False
2011-04-12,12,2437,9,83,92,False
2011-04-12,13,2438,22,84,106,False
2011-04-12,14,2439,16,28,44,False
2011-04-12,15,2440,24,54,78,False
2011-04-12,16,2441,19,80,99,False
2011-04-12,17,2442,29,262,291,False
2011-04-12,18,2443,21,203,224,False
2011-04-12,19,2444,3,127,130,False
2011-04-12,20,2445,9,94,103,False
2011-04-12,21,2446,10,74,84,False
2011-04-12,22,2447,7,47,54,False
2011-04-12,23,2448,8,31,39,False
2011-04-13,0,2449,3,12,15,False
2011-04-13,1,2450,0,1,1,False
2011-04-13,2,2451,0,2,2,False
2011-04-13,3,2452,0,2,2,False
2011-04-13,4,2453,1,2,3,False
2011-04-13,5,2454,1,4,5,False
2011-04-13,6,2455,1,33,34,False
2011-04-13,7,2456,3,67,70,False
2011-04-13,8,2457,6,158,164,False
2011-04-13,9,2458,2,63,65,False
2011-04-13,10,2459,4,42,46,False
2011-04-13,11,2460,4,57,61,False
2011-04-13,12,2461,12,83,95,False
2011-04-13,13,2462,6,55,61,False
2011-04-13,14,2463,24,82,106,False
2011-04-13,15,2464,12,69,81,False
2011-04-13,16,2465,23,119,142,False
2011-04-13,17,2466,25,284,309,False
2011-04-13,18,2467,28,293,321,False
2011-04-13,19,2468,15,160,175,False
2011-04-13,20,2469,7,119,126,False
2011-04-13,21,2470,17,100,117,False
2011-04-13,22,2471,10,89,99,False
2011-04-13,23,2472,5,57,62,False
2011-04-14,0,2473,3,18,21,False
2011-04-14,1,2474,1,9,10,False
2011-04-14,2,2475,0,3,3,False
2011-04-14,3,2476,0,2,2,False
2011-04-14,4,2477,1,8,9,False
2011-04-14,5,2478,2,12,14,False
2011-04-14,6,2479,4,66,70,False
2011-04-14,7,2480,11,182,193,False
2011-04-14,8,2481,21,316,337,False
2011-04-14,9,2482,18,152,170,False
2011-04-14,10,2483,21,68,89,False
2011-04-14,11,2484,28,87,115,False
2011-04-14,12,2485,35,110,145,False
2011-04-14,13,2486,38,121,159,False
2011-04-14,14,2487,36,101,137,False
2011-04-14,15,2488,57,85,142,False
2011-04-14,16,2489,49,153,202,False
2011-04-14,17,2490,50,338,388,False
2011-04-14,18,2491,47,290,337,False
2011-04-14,19,2492,37,222,259,False
2011-04-14,20,2493,22,147,169,False
2011-04-14,21,2494,19,126,145,False
2011-04-14,22,2495,22,82,104,False
2011-04-14,23,2496,7,40,47,False
2011-04-15,0,2497,6,21,27,False
2011-04-15,1,2498,6,9,15,False
2011-04-15,2,2499,8,10,18,False
2011-04-15,3,2500,0,3,3,False
2011-04-15,4,2501,0,3,3,False
2011-04-15,5,2502,2,11,13,False
2011-04-15,6,2503,5,42,47,False
2011-04-15,7,2504,10,139,149,False
2011-04-15,8,2505,21,279,300,False
2011-04-15,9,2506,16,162,178,False
2011-04-15,10,2507,31,91,122,False
2011-04-15,11,2508,41,95,136,False
2011-04-15,12,2509,45,155,200,False
2011-04-15,13,2510,47,133,180,False
2011-04-15,14,2511,57,106,163,False
2011-04-15,15,2512,50,112,162,False
2011-04-15,16,2513,70,173,243,False
2011-04-15,17,2514,64,267,331,False
2011-04-15,18,2515,47,216,263,False
2011-04-15,19,2516,41,168,209,False
2011-04-15,20,2517,26,92,118,False
2011-04-15,21,2518,25,77,102,False
2011-04-15,22,2519,16,64,80,False
2011-04-15,23,2520,8,56,64,False
2011-04-16,0,2521,7,36,43,False
2011-04-16,1,2522,5,28,33,False
2011-04-16,2,2523,5,19,24,False
2011-04-16,3,2524,5,9,14,False
2011-04-16,4,2525,1,4,5,False
2011-04-16,5,2526,1,3,4,False
2011-04-16,6,2527,1,9,10,False
2011-04-16,7,2528,3,18,21,False
2011-04-16,8,2529,7,38,45,False
2011-04-16,9,2530,2,27,29,False
2011-04-16,10,2531,1,21,22,False
2011-04-16,11,2532,4,27,31,False
2011-04-16,12,2533,6,26,32,False
2011-04-16,13,2534,9,49,58,False
2011-04-16,14,2535,14,49,63,False
2011-04-16,15,2536,16,62,78,False
2011-04-16,16,2537,6,27,33,False
2011-04-16,17,2538,1,14,15,False
2011-04-16,18,2539,6,32,38,False
2011-04-16,19,2540,9,62,71,False
2011-04-16,20,2541,4,49,53,False
2011-04-16,21,2542,1,13,14,False
2011-04-16,22,2543,2,22,24,False
2011-04-16,23,2544,5,30,35,False
2011-04-17,0,2545,4,29,33,False
2011-04-17,1,2546,6,25,31,False
2011-04-17,2,2547,4,25,29,False
2011-04-17,3,2548,12,13,25,False
2011-04-17,4,2549,2,5,7,False
2011-04-17,5,2550,2,1,3,False
2011-04-17,6,2551,3,5,8,False
2011-04-17,7,2552,2,14,16,False
2011-04-17,8,2553,7,36,43,False
2011-04-17,9,2554,31,71,102,False
2011-04-17,10,2555,91,120,211,False
2011-04-17,11,2556,119,185,304,False
2011-04-17,12,2557,167,187,354,False
2011-04-17,13,2558,181,162,343,False
2011-04-17,14,2559,170,191,361,False
2011-04-17,15,2560,179,209,388,False
2011-04-17,16,2561,161,182,343,False
2011-04-17,17,2562,143,163,306,False
2011-04-17,18,2563,102,175,277,False
2011-04-17,19,2564,75,135,210,False
2011-04-17,20,2565,44,97,141,False
2011-04-17,21,2566,13,70,83,False
2011-04-17,22,2567,21,49,70,False
2011-04-17,23,2568,19,37,56,False
2011-04-18,0,2569,15,24,39,False
2011-04-18,1,2570,11,8,19,False
2011-04-18,2,2571,14,2,16,False
2011-04-18,3,2572,6,1,7,False
2011-04-18,4,2573,2,4,6,False
2011-04-18,5,2574,0,16,16,False
2011-04-18,6,2575,3,51,54,False
2011-04-18,7,2576,12,156,168,False
2011-04-18,8,2577,20,277,297,False
2011-04-18,9,2578,37,132,169,False
2011-04-18,10,2579,41,68,109,False
2011-04-18,11,2580,36,87,123,False
2011-04-18,12,2581,60,124,184,False
2011-04-18,13,2582,41,128,169,False
2011-04-18,14,2583,49,95,144,False
2011-04-18,15,2584,64,112,176,False
2011-04-18,16,2585,40,165,205,False
2011-04-18,17,2586,66,362,428,False
2011-04-18,18,2587,41,321,362,False
2011-04-18,19,2588,42,244,286,False
2011-04-18,20,2589,29,136,165,False
2011-04-18,21,2590,20,131,151,False
2011-04-18,22,2591,9,81,90,False
2011-04-18,23,2592,11,35,46,False
2011-04-19,0,2593,2,23,25,False
2011-04-19,1,2594,5,2,7,False
2011-04-19,2,2595,8,5,13,False
2011-04-19,3,2596,0,3,3,False
2011-04-19,4,2597,1,4,5,False
2011-04-19,5,2598,1,17,18,False
2011-04-19,6,2599,2,63,65,False
2011-04-19,7,2600,22,166,188,False
2011-04-19,8,2601,20,331,351,False
2011-04-19,9,2602,23,139,162,False
2011-04-19,10,2603,15,60,75,False
2011-04-19,11,2604,19,53,72,False
2011-04-19,12,2605,19,84,103,False
2011-04-19,13,2606,26,103,129,False
2011-04-19,14,2607,19,88,107,False
2011-04-19,15,2608,44,83,127,False
2011-04-19,16,2609,30,162,192,False
2011-04-19,17,2610,39,372,411,False
2011-04-19,18,2611,44,377,421,False
2011-04-19,19,2612,28,248,276,False
2011-04-19,20,2613,20,148,168,False
2011-04-19,21,2614,8,114,122,False
2011-04-19,22,2615,3,109,112,False
2011-04-19,23,2616,11,41,52,False
2011-04-20,0,2617,4,29,33,False
2011-04-20,1,2618,2,5,7,False
2011-04-20,2,2619,0,2,2,False
2011-04-20,3,2620,0,2,2,False
2011-04-20,4,2621,5,4,9,False
2011-04-20,5,2622,1,14,15,False
2011-04-20,6,2623,2,62,64,False
2011-04-20,7,2624,26,211,237,False
2011-04-20,8,2625,22,374,396,False
2011-04-20,9,2626,27,170,197,False
2011-04-20,10,2627,45,86,131,False
2011-04-20,11,2628,31,87,118,False
2011-04-20,12,2629,28,117,145,False
2011-04-20,13,2630,42,135,177,False
2011-04-20,14,2631,33,115,148,False
2011-04-20,15,2632,32,113,145,False
2011-04-20,16,2633,54,201,255,False
2011-04-20,17,2634,34,398,432,False
2011-04-20,18,2635,56,385,441,False
2011-04-20,19,2636,74,309,383,False
2011-04-20,20,2637,31,194,225,False
2011-04-20,21,2638,38,134,172,False
2011-04-20,22,2639,12,105,117,False
2011-04-20,23,2640,14,79,93,False
2011-04-21,0,2641,11,33,44,False
2011-04-21,1,2642,6,20,26,False
2011-04-21,2,2643,3,10,13,False
2011-04-21,3,2644,4,3,7,False
2011-04-21,4,2645,2,4,6,False
2011-04-21,5,2646,0,14,14,False
2011-04-21,6,2647,2,73,75,False
2011-04-21,7,2648,15,183,198,False
2011-04-21,8,2649,19,346,365,False
2011-04-21,9,2650,18,178,196,False
2011-04-21,10,2651,25,73,98,False
2011-04-21,11,2652,34,99,133,False
2011-04-21,12,2653,49,150,199,False
2011-04-21,13,2654,55,122,177,False
2011-04-21,14,2655,68,160,228,False
2011-04-21,15,2656,69,166,235,False
2011-04-21,16,2657,66,228,294,False
2011-04-21,17,2658,79,402,481,False
2011-04-21,18,2659,71,381,452,False
2011-04-21,19,2660,52,272,324,False
2011-04-21,20,2661,28,176,204,False
2011-04-21,21,2662,25,159,184,False
2011-04-21,22,2663,31,106,137,False
2011-04-21,23,2664,13,86,99,False
2011-04-22,0,2665,3,30,33,False
2011-04-22,1,2666,2,22,24,False
2011-04-22,2,2667,2,7,9,False
2011-04-22,3,2668,0,2,2,False
2011-04-22,4,2669,1,2,3,False
2011-04-22,5,2670,0,16,16,False
2011-04-22,6,2671,2,47,49,False
2011-04-22,7,2672,5,175,180,False
2011-04-22,8,2673,15,331,346,False
2011-04-22,9,2674,17,178,195,False
2011-04-22,10,2675,32,104,136,False
2011-04-22,11,2676,23,83,106,False
2011-04-22,12,2677,19,61,80,False
2011-04-22,13,2678,3,37,40,False
2011-04-22,14,2679,3,33,36,False
2011-04-22,15,2680,13,62,75,False
2011-04-22,16,2681,4,58,62,False
2011-04-22,17,2682,6,63,69,False
2011-04-22,18,2683,4,47,51,False
2011-04-22,19,2684,7,48,55,False
2011-04-22,20,2685,8,39,47,False
2011-04-22,21,2686,5,23,28,False
2011-04-22,22,2687,3,21,24,False
2011-04-22,23,2688,0,17,17,False
2011-04-23,0,2689,0,18,18,False
2011-04-23,1,2690,5,11,16,False
2011-04-23,2,2691,3,14,17,False
2011-04-23,3,2692,0,4,4,False
2011-04-23,4,2693,2,3,5,False
2011-04-23,5,2694,1,6,7,False
2011-04-23,6,2695,0,11,11,False
2011-04-23,7,2696,2,17,19,False
2011-04-23,8,2697,15,32,47,False
2011-04-23,9,2698,13,55,68,False
2011-04-23,10,2699,36,93,129,False
2011-04-23,11,2700,68,164,232,False
2011-04-23,12,2701,94,197,291,False
2011-04-23,13,2702,126,186,312,False
2011-04-23,14,2703,182,209,391,False
2011-04-23,15,2704,171,226,397,False
2011-04-23,16,2705,180,246,426,False
2011-04-23,17,2706,168,215,383,False
2011-04-23,18,2707,149,227,376,False
2011-04-23,19,2708,84,199,283,False
2011-04-23,20,2709,45,138,183,False
2011-04-23,21,2710,32,103,135,False
2011-04-23,22,2711,55,114,169,False
2011-04-23,23,2712,31,86,117,False
2011-04-24,0,2713,30,66,96,False
2011-04-24,1,2714,14,40,54,False
2011-04-24,2,2715,27,45,72,False
2011-04-24,3,2716,4,20,24,False
2011-04-24,4,2717,0,5,5,False
2011-04-24,5,2718,5,7,12,False
2011-04-24,6,2719,10,3,13,False
2011-04-24,7,2720,16,11,27,False
2011-04-24,8,2721,38,42,80,False
2011-04-24,9,2722,73,104,177,False
2011-04-24,10,2723,118,171,289,False
2011-04-24,11,2724,124,193,317,False
2011-04-24,12,2725,168,220,388,False
2011-04-24,13,2726,205,236,441,False
2011-04-24,14,2727,197,223,420,False
2011-04-24,15,2728,167,202,369,False
2011-04-24,16,2729,162,197,359,False
2011-04-24,17,2730,142,189,331,False
2011-04-24,18,2731,96,174,270,False
2011-04-24,19,2732,62,132,194,False
2011-04-24,20,2733,34,71,105,False
2011-04-24,21,2734,8,53,61,False
2011-04-24,22,2735,5,40,45,False
2011-04-24,23,2736,5,37,42,False
2011-04-25,0,2737,2,10,12,False
2011-04-25,1,2738,2,8,10,False
2011-04-25,2,2739,1,9,10,False
2011-04-25,3,2740,2,8,10,False
2011-04-25,4,2741,1,4,5,False
2011-04-25,5,2742,3,14,17,False
2011-04-25,6,2743,7,59,66,False
2011-04-25,7,2744,13,183,196,False
2011-04-25,8,2745,27,326,353,False
2011-04-25,9,2746,27,147,174,False
2011-04-25,10,2747,61,64,125,False
2011-04-25,11,2748,53,94,147,False
2011-04-25,12,2749,48,140,188,False
2011-04-25,13,2750,57,146,203,False
2011-04-25,14,2751,47,99,146,False
2011-04-25,15,2752,50,125,175,False
2011-04-25,16,2753,41,198,239,False
2011-04-25,17,2754,80,441,521,False
2011-04-25,18,2755,74,425,499,False
2011-04-25,19,2756,62,320,382,False
2011-04-25,20,2757,42,195,237,False
2011-04-25,21,2758,41,149,190,False
2011-04-25,22,2759,23,83,106,False
2011-04-25,23,2760,9,53,62,False
2011-04-26,0,2761,10,17,27,False
2011-04-26,1,2762,16,5,21,False
2011-04-26,2,2763,17,9,26,False
2011-04-26,3,2764,17,4,21,False
2011-04-26,4,2765,2,4,6,False
2011-04-26,5,2766,0,16,16,False
2011-04-26,6,2767,0,80,80,False
2011-04-26,7,2768,16,254,270,False
2011-04-26,8,2769,32,417,449,False
2011-04-26,9,2770,35,164,199,False
2011-04-26,10,2771,22,98,120,False
2011-04-26,11,2772,40,132,172,False
2011-04-26,12,2773,40,146,186,False
2011-04-26,13,2774,37,139,176,False
2011-04-26,14,2775,40,115,155,False
2011-04-26,15,2776,34,119,153,False
2011-04-26,16,2777,40,251,291,False
2011-04-26,17,2778,66,455,521,False
2011-04-26,18,2779,65,463,528,False
2011-04-26,19,2780,42,286,328,False
2011-04-26,20,2781,35,199,234,False
2011-04-26,21,2782,33,162,195,False
2011-04-26,22,2783,32,116,148,False
2011-04-26,23,2784,7,71,78,False
2011-04-27,0,2785,3,24,27,False
2011-04-27,1,2786,2,15,17,False
2011-04-27,2,2787,0,5,5,False
2011-04-27,3,2788,3,4,7,False
2011-04-27,4,2789,0,6,6,False
2011-04-27,5,2790,1,16,17,False
2011-04-27,6,2791,5,79,84,False
2011-04-27,7,2792,17,229,246,False
2011-04-27,8,2793,31,413,444,False
2011-04-27,9,2794,20,161,181,False
2011-04-27,10,2795,26,66,92,False
2011-04-27,11,2796,53,103,156,False
2011-04-27,12,2797,38,135,173,False
2011-04-27,13,2798,31,119,150,False
2011-04-27,14,2799,29,119,148,False
2011-04-27,15,2800,18,120,138,False
2011-04-27,16,2801,29,189,218,False
2011-04-27,17,2802,63,458,521,False
2011-04-27,18,2803,46,366,412,False
2011-04-27,19,2804,40,220,260,False
2011-04-27,20,2805,30,188,218,False
2011-04-27,21,2806,19,126,145,False
2011-04-27,22,2807,18,111,129,False
2011-04-27,23,2808,25,53,78,False
2011-04-28,0,2809,13,41,54,False
2011-04-28,1,2810,8,12,20,False
2011-04-28,2,2811,14,7,21,False
2011-04-28,3,2812,2,1,3,False
2011-04-28,4,2813,4,5,9,False
2011-04-28,5,2814,0,13,13,False
2011-04-28,6,2815,7,79,86,False
2011-04-28,7,2816,14,201,215,False
2011-04-28,8,2817,31,367,398,False
2011-04-28,9,2818,18,165,183,False
2011-04-28,10,2819,9,45,54,False
2011-04-28,11,2820,10,74,84,False
2011-04-28,12,2821,23,84,107,False
2011-04-28,13,2822,18,103,121,False
2011-04-28,14,2823,21,121,142,False
2011-04-28,15,2824,46,117,163,False
2011-04-28,16,2825,42,228,270,False
2011-04-28,17,2826,49,406,455,False
2011-04-28,18,2827,44,486,530,False
2011-04-28,19,2828,57,347,404,False
2011-04-28,20,2829,49,220,269,False
2011-04-28,21,2830,27,167,194,False
2011-04-28,22,2831,34,119,153,False
2011-04-28,23,2832,29,81,110,False
2011-04-29,0,2833,11,37,48,False
2011-04-29,1,2834,10,21,31,False
2011-04-29,2,2835,2,8,10,False
2011-04-29,3,2836,1,4,5,False
2011-04-29,4,2837,0,6,6,False
2011-04-29,5,2838,0,25,25,False
2011-04-29,6,2839,4,67,71,False
2011-04-29,7,2840,18,222,240,False
2011-04-29,8,2841,35,386,421,False
2011-04-29,9,2842,45,185,230,False
2011-04-29,10,2843,57,99,156,False
2011-04-29,11,2844,49,108,157,False
2011-04-29,12,2845,63,160,223,False
2011-04-29,13,2846,74,234,308,False
2011-04-29,14,2847,58,190,248,False
2011-04-29,15,2848,77,175,252,False
2011-04-29,16,2849,59,240,299,False
2011-04-29,17,2850,75,433,508,False
2011-04-29,18,2851,55,384,439,False
2011-04-29,19,2852,40,230,270,False
2011-04-29,20,2853,34,160,194,False
2011-04-29,21,2854,50,145,195,False
2011-04-29,22,2855,36,110,146,False
2011-04-29,23,2856,25,88,113,False
2011-04-30,0,2857,33,73,106,False
2011-04-30,1,2858,15,59,74,False
2011-04-30,2,2859,12,53,65,False
2011-04-30,3,2860,4,13,17,False
2011-04-30,4,2861,2,5,7,False
2011-04-30,5,2862,3,4,7,False
2011-04-30,6,2863,10,11,21,False
2011-04-30,7,2864,21,27,48,False
2011-04-30,8,2865,21,70,91,False
2011-04-30,9,2866,35,121,156,False
2011-04-30,10,2867,94,185,279,False
2011-04-30,11,2868,120,201,321,False
2011-04-30,12,2869,178,238,416,False
2011-04-30,13,2870,185,270,455,False
2011-04-30,14,2871,184,268,452,False
2011-04-30,15,2872,217,282,499,False
2011-04-30,16,2873,191,273,464,False
2011-04-30,17,2874,162,245,407,False
2011-04-30,18,2875,134,237,371,False
2011-04-30,19,2876,150,237,387,False
2011-04-30,20,2877,65,159,224,False
2011-04-30,21,2878,58,119,177,False
2011-04-30,22,2879,37,106,143,False
2011-04-30,23,2880,34,91,125,False
2011-05-01,0,2881,19,77,96,False
2011-05-01,1,2882,9,50,59,False
2011-05-01,2,2883,7,43,50,False
2011-05-01,3,2884,8,15,23,False
2011-05-01,4,2885,6,11,17,False
2011-05-01,5,2886,0,10,10,False
2011-05-01,6,2887,4,9,13,False
2011-05-01,7,2888,7,26,33,False
2011-05-01,8,2889,16,43,59,False
2011-05-01,9,2890,45,96,141,False
2011-05-01,10,2891,109,155,264,False
2011-05-01,11,2892,109,141,250,False
2011-05-01,12,2893,109,172,281,False
2011-05-01,13,2894,123,209,332,False
2011-05-01,14,2895,85,153,238,False
2011-05-01,15,2896,113,153,266,False
2011-05-01,16,2897,75,139,214,False
2011-05-01,17,2898,60,136,196,False
2011-05-01,18,2899,33,126,159,False
2011-05-01,19,2900,47,131,178,False
2011-05-01,20,2901,35,86,121,False
2011-05-01,21,2902,23,82,105,False
2011-05-01,22,2903,32,68,100,False
2011-05-01,23,2904,64,82,146,False
2011-05-02,0,2905,68,109,177,False
2011-05-02,1,2906,41,73,114,False
2011-05-02,2,2907,16,19,35,False
2011-05-02,3,2908,9,7,16,False
2011-05-02,4,2909,9,8,17,False
2011-05-02,5,2910,4,16,20,False
2011-05-02,6,2911,3,59,62,False
2011-05-02,7,2912,16,193,209,False
2011-05-02,8,2913,21,350,371,False
2011-05-02,9,2914,41,131,172,False
2011-05-02,10,2915,31,77,108,False
2011-05-02,11,2916,34,96,130,False
2011-05-02,12,2917,40,147,187,False
2011-05-02,13,2918,51,119,170,False
2011-05-02,14,2919,48,133,181,False
2011-05-02,15,2920,45,110,155,False
2011-05-02,16,2921,49,220,269,False
2011-05-02,17,2922,65,472,537,False
2011-05-02,18,2923,68,450,518,False
2011-05-02,19,2924,46,268,314,False
2011-05-02,20,2925,44,174,218,False
2011-05-02,21,2926,54,178,232,False
2011-05-02,22,2927,28,97,125,False
2011-05-02,23,2928,16,48,64,False
2011-05-03,0,2929,0,16,16,False
2011-05-03,1,2930,0,14,14,False
2011-05-03,2,2931,0,5,5,False
2011-05-03,3,2932,0,2,2,False
2011-05-03,4,2933,3,1,4,False
2011-05-03,5,2934,0,14,14,False
2011-05-03,6,2935,7,102,109,False
2011-05-03,7,2936,17,248,265,False
2011-05-03,8,2937,24,435,459,False
2011-05-03,9,2938,29,157,186,False
2011-05-03,10,2939,36,91,127,False
2011-05-03,11,2940,20,120,140,False
2011-05-03,12,2941,48,169,217,False
2011-05-03,13,2942,50,144,194,False
2011-05-03,14,2943,36,122,158,False
2011-05-03,15,2944,37,117,154,False
2011-05-03,16,2945,46,225,271,False
2011-05-03,17,2946,53,464,517,False
2011-05-03,18,2947,59,485,544,False
2011-05-03,19,2948,42,323,365,False
2011-05-03,20,2949,28,262,290,False
2011-05-03,21,2950,42,183,225,False
2011-05-03,22,2951,14,99,113,False
2011-05-03,23,2952,12,50,62,False
2011-05-04,0,2953,5,22,27,False
2011-05-04,1,2954,1,6,7,False
2011-05-04,2,2955,0,4,4,False
2011-05-04,3,2956,0,1,1,False
2011-05-04,4,2957,1,2,3,False
2011-05-04,5,2958,1,8,9,False
2011-05-04,6,2959,0,21,21,False
2011-05-04,7,2960,6,46,52,False
2011-05-04,8,2961,5,74,79,False
2011-05-04,9,2962,5,35,40,False
2011-05-04,10,2963,5,26,31,False
2011-05-04,11,2964,3,69,72,False
2011-05-04,12,2965,19,105,124,False
2011-05-04,13,2966,15,128,143,False
2011-05-04,14,2967,13,94,107,False
2011-05-04,15,2968,22,107,129,False
2011-05-04,16,2969,22,173,195,False
2011-05-04,17,2970,22,388,410,False
2011-05-04,18,2971,29,367,396,False
2011-05-04,19,2972,30,266,296,False
2011-05-04,20,2973,17,174,191,False
2011-05-04,21,2974,17,133,150,False
2011-05-04,22,2975,9,80,89,False
2011-05-04,23,2976,8,49,57,False
2011-05-05,0,2977,4,23,27,False
2011-05-05,1,2978,4,6,10,False
2011-05-05,2,2979,1,4,5,False
2011-05-05,3,2980,0,4,4,False
2011-05-05,4,2981,4,3,7,False
2011-05-05,5,2982,1,29,30,False
2011-05-05,6,2983,3,86,89,False
2011-05-05,7,2984,16,255,271,False
2011-05-05,8,2985,25,415,440,False
2011-05-05,9,2986,20,164,184,False
2011-05-05,10,2987,30,98,128,False
2011-05-05,11,2988,43,105,148,False
2011-05-05,12,2989,27,169,196,False
2011-05-05,13,2990,50,142,192,False
2011-05-05,14,2991,19,135,154,False
2011-05-05,15,2992,27,120,147,False
2011-05-05,16,2993,36,233,269,False
2011-05-05,17,2994,66,467,533,False
2011-05-05,18,2995,64,456,520,False
2011-05-05,19,2996,56,305,361,False
2011-05-05,20,2997,33,225,258,False
2011-05-05,21,2998,39,141,180,False
2011-05-05,22,2999,30,135,165,False
2011-05-05,23,3000,16,99,115,False
2011-05-06,0,3001,13,43,56,False
2011-05-06,1,3002,8,24,32,False
2011-05-06,2,3003,1,15,16,False
2011-05-06,3,3004,3,6,9,False
2011-05-06,4,3005,0,1,1,False
2011-05-06,5,3006,0,16,16,False
2011-05-06,6,3007,8,74,82,False
2011-05-06,7,3008,20,202,222,False
2011-05-06,8,3009,35,415,450,False
2011-05-06,9,3010,27,161,188,False
2011-05-06,10,3011,30,97,127,False
2011-05-06,11,3012,42,123,165,False
2011-05-06,12,3013,48,198,246,False
2011-05-06,13,3014,71,182,253,False
2011-05-06,14,3015,86,127,213,False
2011-05-06,15,3016,89,171,260,False
2011-05-06,16,3017,82,262,344,False
2011-05-06,17,3018,83,470,553,False
2011-05-06,18,3019,85,385,470,False
2011-05-06,19,3020,39,253,292,False
2011-05-06,20,3021,29,161,190,False
2011-05-06,21,3022,22,130,152,False
2011-05-06,22,3023,46,105,151,False
2011-05-06,23,3024,27,93,120,False
2011-05-07,0,3025,10,76,86,False
2011-05-07,1,3026,8,50,58,False
2011-05-07,2,3027,5,47,52,False
2011-05-07,3,3028,9,9,18,False
2011-05-07,4,3029,1,4,5,False
2011-05-07,5,3030,4,3,7,False
2011-05-07,6,3031,1,12,13,False
2011-05-07,7,3032,8,32,40,False
2011-05-07,8,3033,19,96,115,False
2011-05-07,9,3034,54,164,218,False
2011-05-07,10,3035,90,208,298,False
2011-05-07,11,3036,132,215,347,False
2011-05-07,12,3037,129,244,373,False
2011-05-07,13,3038,196,240,436,False
2011-05-07,14,3039,143,235,378,False
2011-05-07,15,3040,148,230,378,False
2011-05-07,16,3041,119,223,342,False
2011-05-07,17,3042,138,216,354,False
2011-05-07,18,3043,114,175,289,False
2011-05-07,19,3044,88,179,267,False
2011-05-07,20,3045,82,137,219,False
2011-05-07,21,3046,58,124,182,False
2011-05-07,22,3047,26,94,120,False
2011-05-07,23,3048,30,89,119,False
2011-05-08,0,3049,22,78,100,False
2011-05-08,1,3050,8,56,64,False
2011-05-08,2,3051,17,42,59,False
2011-05-08,3,3052,10,21,31,False
2011-05-08,4,3053,2,8,10,False
2011-05-08,5,3054,0,5,5,False
2011-05-08,6,3055,2,4,6,False
2011-05-08,7,3056,8,15,23,False
2011-05-08,8,3057,28,58,86,False
2011-05-08,9,3058,48,112,160,False
2011-05-08,10,3059,91,153,244,False
2011-05-08,11,3060,142,198,340,False
2011-05-08,12,3061,139,243,382,False
2011-05-08,13,3062,166,224,390,False
2011-05-08,14,3063,126,240,366,False
2011-05-08,15,3064,128,230,358,False
2011-05-08,16,3065,122,263,385,False
2011-05-08,17,3066,106,245,351,False
2011-05-08,18,3067,63,205,268,False
2011-05-08,19,3068,61,178,239,False
2011-05-08,20,3069,42,132,174,False
2011-05-08,21,3070,32,95,127,False
2011-05-08,22,3071,29,86,115,False
2011-05-08,23,3072,9,41,50,False
2011-05-09,0,3073,31,22,53,False
2011-05-09,1,3074,25,8,33,False
2011-05-09,2,3075,6,2,8,False
2011-05-09,3,3076,0,7,7,False
2011-05-09,4,3077,0,4,4,False
2011-05-09,5,3078,0,23,23,False
2011-05-09,6,3079,2,87,89,False
2011-05-09,7,3080,16,221,237,False
2011-05-09,8,3081,23,351,374,False
2011-05-09,9,3082,36,142,178,False
2011-05-09,10,3083,24,95,119,False
2011-05-09,11,3084,26,99,125,False
2011-05-09,12,3085,35,160,195,False
2011-05-09,13,3086,36,138,174,False
2011-05-09,14,3087,44,118,162,False
2011-05-09,15,3088,51,148,199,False
2011-05-09,16,3089,49,255,304,False
2011-05-09,17,3090,59,539,598,False
2011-05-09,18,3091,66,458,524,False
2011-05-09,19,3092,45,339,384,False
2011-05-09,20,3093,25,214,239,False
2011-05-09,21,3094,28,128,156,False
2011-05-09,22,3095,21,95,116,False
2011-05-09,23,3096,16,45,61,False
2011-05-10,0,3097,6,12,18,False
2011-05-10,1,3098,3,12,15,False
2011-05-10,2,3099,1,4,5,False
2011-05-10,3,3100,1,3,4,False
2011-05-10,4,3101,0,2,2,False
2011-05-10,5,3102,1,28,29,False
2011-05-10,6,3103,9,103,112,False
2011-05-10,7,3104,13,301,314,False
2011-05-10,8,3105,28,397,425,False
2011-05-10,9,3106,29,176,205,False
2011-05-10,10,3107,27,100,127,False
2011-05-10,11,3108,17,108,125,False
2011-05-10,12,3109,47,170,217,False
2011-05-10,13,3110,50,152,202,False
2011-05-10,14,3111,42,134,176,False
2011-05-10,15,3112,28,152,180,False
2011-05-10,16,3113,56,271,327,False
2011-05-10,17,3114,79,532,611,False
2011-05-10,18,3115,70,480,550,False
2011-05-10,19,3116,69,365,434,False
2011-05-10,20,3117,50,241,291,False
2011-05-10,21,3118,30,173,203,False
2011-05-10,22,3119,29,121,150,False
2011-05-10,23,3120,9,72,81,False
2011-05-11,0,3121,8,30,38,False
2011-05-11,1,3122,4,16,20,False
2011-05-11,2,3123,6,4,10,False
2011-05-11,3,3124,0,3,3,False
2011-05-11,4,3125,0,2,2,False
2011-05-11,5,3126,0,20,20,False
2011-05-11,6,3127,6,93,99,False
2011-05-11,7,3128,25,293,318,False
2011-05-11,8,3129,21,421,442,False
2011-05-11,9,3130,21,182,203,False
2011-05-11,10,3131,30,124,154,False
2011-05-11,11,3132,18,123,141,False
2011-05-11,12,3133,41,185,226,False
2011-05-11,13,3134,36,157,193,False
2011-05-11,14,3135,36,141,177,False
2011-05-11,15,3136,48,131,179,False
2011-05-11,16,3137,49,240,289,False
2011-05-11,17,3138,17,242,259,False
2011-05-11,18,3139,40,234,274,False
2011-05-11,19,3140,60,341,401,False
2011-05-11,20,3141,28,245,273,False
2011-05-11,21,3142,32,202,234,False
2011-05-11,22,3143,12,134,146,False
2011-05-11,23,3144,12,69,81,False
2011-05-12,0,3145,5,39,44,False
2011-05-12,1,3146,1,16,17,False
2011-05-12,2,3147,1,14,15,False
2011-05-12,3,3148,0,5,5,False
2011-05-12,4,3149,1,5,6,False
2011-05-12,5,3150,2,27,29,False
2011-05-12,6,3151,9,103,112,False
2011-05-12,7,3152,14,283,297,False
2011-05-12,8,3153,27,394,421,False
2011-05-12,9,3154,21,191,212,False
2011-05-12,10,3155,28,119,147,False
2011-05-12,11,3156,43,136,179,False
2011-05-12,12,3157,43,164,207,False
2011-05-12,13,3158,48,170,218,False
2011-05-12,14,3159,43,148,191,False
2011-05-12,15,3160,54,163,217,False
2011-05-12,16,3161,50,238,288,False
2011-05-12,17,3162,54,540,594,False
2011-05-12,18,3163,64,463,527,False
2011-05-12,19,3164,59,305,364,False
2011-05-12,20,3165,56,220,276,False
2011-05-12,21,3166,31,192,223,False
2011-05-12,22,3167,25,147,172,False
2011-05-12,23,3168,16,87,103,False
2011-05-13,0,3169,6,46,52,False
2011-05-13,1,3170,5,15,20,False
2011-05-13,2,3171,3,8,11,False
2011-05-13,3,3172,2,2,4,False
2011-05-13,4,3173,2,3,5,False
2011-05-13,5,3174,1,24,25,False
2011-05-13,6,3175,6,76,82,False
2011-05-13,7,3176,16,141,157,False
2011-05-13,8,3177,26,361,387,False
2011-05-13,9,3178,18,215,233,False
2011-05-13,10,3179,31,99,130,False
2011-05-13,11,3180,56,90,146,False
2011-05-13,12,3181,53,170,223,False
2011-05-13,13,3182,69,157,226,False
2011-05-13,14,3183,70,120,190,False
2011-05-13,15,3184,56,142,198,False
2011-05-13,16,3185,44,256,300,False
2011-05-13,17,3186,62,429,491,False
2011-05-13,18,3187,39,359,398,False
2011-05-13,19,3188,25,245,270,False
2011-05-13,20,3189,22,130,152,False
2011-05-13,21,3190,24,130,154,False
2011-05-13,22,3191,25,107,132,False
2011-05-13,23,3192,31,88,119,False
2011-05-14,0,3193,24,78,102,False
2011-05-14,1,3194,18,64,82,False
2011-05-14,2,3195,15,37,52,False
2011-05-14,3,3196,5,30,35,False
2011-05-14,4,3197,1,4,5,False
2011-05-14,5,3198,7,7,14,False
2011-05-14,6,3199,2,9,11,False
2011-05-14,7,3200,4,28,32,False
2011-05-14,8,3201,16,72,88,False
2011-05-14,9,3202,14,86,100,False
2011-05-14,10,3203,34,133,167,False
2011-05-14,11,3204,72,207,279,False
2011-05-14,12,3205,75,204,279,False
2011-05-14,13,3206,68,180,248,False
2011-05-14,14,3207,57,159,216,False
2011-05-14,15,3208,73,221,294,False
2011-05-14,16,3209,107,188,295,False
2011-05-14,17,3210,78,194,272,False
2011-05-14,18,3211,88,216,304,False
2011-05-14,19,3212,69,179,248,False
2011-05-14,20,3213,42,115,157,False
2011-05-14,21,3214,15,44,59,False
2011-05-14,22,3215,7,19,26,False
2011-05-14,23,3216,11,33,44,False
2011-05-15,0,3217,5,34,39,False
2011-05-15,1,3218,4,43,47,False
2011-05-15,2,3219,13,37,50,False
2011-05-15,3,3220,11,21,32,False
2011-05-15,4,3221,5,8,13,False
2011-05-15,5,3222,3,11,14,False
2011-05-15,6,3223,3,14,17,False
2011-05-15,7,3224,4,38,42,False
2011-05-15,8,3225,24,46,70,False
2011-05-15,9,3226,36,98,134,False
2011-05-15,10,3227,73,153,226,False
2011-05-15,11,3228,120,202,322,False
2011-05-15,12,3229,120,247,367,False
2011-05-15,13,3230,195,261,456,False
2011-05-15,14,3231,183,254,437,False
2011-05-15,15,3232,206,253,459,False
2011-05-15,16,3233,158,282,440,False
2011-05-15,17,3234,137,255,392,False
2011-05-15,18,3235,60,177,237,False
2011-05-15,19,3236,78,153,231,False
2011-05-15,20,3237,53,138,191,False
2011-05-15,21,3238,44,107,151,False
2011-05-15,22,3239,29,88,117,False
2011-05-15,23,3240,18,51,69,False
2011-05-16,0,3241,17,21,38,False
2011-05-16,1,3242,6,8,14,False
2011-05-16,2,3243,4,9,13,False
2011-05-16,3,3244,1,3,4,False
2011-05-16,4,3245,1,5,6,False
2011-05-16,5,3246,1,20,21,False
2011-05-16,6,3247,11,93,104,False
2011-05-16,7,3248,27,245,272,False
2011-05-16,8,3249,28,366,394,False
2011-05-16,9,3250,38,156,194,False
2011-05-16,10,3251,37,75,112,False
2011-05-16,11,3252,56,129,185,False
2011-05-16,12,3253,72,137,209,False
2011-05-16,13,3254,61,153,214,False
2011-05-16,14,3255,76,117,193,False
2011-05-16,15,3256,55,110,165,False
2011-05-16,16,3257,45,181,226,False
2011-05-16,17,3258,47,227,274,False
2011-05-16,18,3259,55,398,453,False
2011-05-16,19,3260,36,272,308,False
2011-05-16,20,3261,31,167,198,False
2011-05-16,21,3262,28,149,177,False
2011-05-16,22,3263,22,105,127,False
2011-05-16,23,3264,18,39,57,False
2011-05-17,0,3265,13,18,31,False
2011-05-17,1,3266,7,6,13,False
2011-05-17,2,3267,4,4,8,False
2011-05-17,3,3268,1,3,4,False
2011-05-17,4,3269,2,2,4,False
2011-05-17,5,3270,0,22,22,False
2011-05-17,6,3271,0,49,49,False
2011-05-17,7,3272,13,138,151,False
2011-05-17,8,3273,22,325,347,False
2011-05-17,9,3274,17,190,207,False
2011-05-17,10,3275,31,73,104,False
2011-05-17,11,3276,26,104,130,False
2011-05-17,12,3277,38,115,153,False
2011-05-17,13,3278,31,141,172,False
2011-05-17,14,3279,61,123,184,False
2011-05-17,15,3280,79,131,210,False
2011-05-17,16,3281,73,217,290,False
2011-05-17,17,3282,83,521,604,False
2011-05-17,18,3283,54,426,480,False
2011-05-17,19,3284,51,298,349,False
2011-05-17,20,3285,30,253,283,False
2011-05-17,21,3286,23,151,174,False
2011-05-17,22,3287,12,86,98,False
2011-05-17,23,3288,7,49,56,False
2011-05-18,0,3289,8,15,23,False
2011-05-18,1,3290,3,9,12,False
2011-05-18,2,3291,1,5,6,False
2011-05-18,3,3292,6,3,9,False
2011-05-18,4,3293,1,2,3,False
2011-05-18,5,3294,0,9,9,False
2011-05-18,6,3295,2,99,101,False
2011-05-18,7,3296,14,260,274,False
2011-05-18,8,3297,25,428,453,False
2011-05-18,9,3298,26,176,202,False
2011-05-18,10,3299,33,73,106,False
2011-05-18,11,3300,6,17,23,False
2011-05-18,12,3301,12,42,54,False
2011-05-18,13,3302,30,92,122,False
2011-05-18,14,3303,44,94,138,False
2011-05-18,15,3304,34,133,167,False
2011-05-18,16,3305,53,241,294,False
2011-05-18,17,3306,78,487,565,False
2011-05-18,18,3307,58,431,489,False
2011-05-18,19,3308,43,288,331,False
2011-05-18,20,3309,24,189,213,False
2011-05-18,21,3310,11,74,85,False
2011-05-18,22,3311,14,103,117,False
2011-05-18,23,3312,10,49,59,False
2011-05-19,0,3313,6,23,29,False
2011-05-19,1,3314,2,4,6,False
2011-05-19,2,3315,3,12,15,False
2011-05-19,3,3316,1,3,4,False
2011-05-19,4,3317,2,3,5,False
2011-05-19,5,3318,2,24,26,False
2011-05-19,6,3319,17,86,103,False
2011-05-19,7,3320,18,239,257,False
2011-05-19,8,3321,34,453,487,False
2011-05-19,9,3322,40,176,216,False
2011-05-19,10,3323,35,95,130,False
2011-05-19,11,3324,53,111,164,False
2011-05-19,12,3325,38,130,168,False
2011-05-19,13,3326,44,139,183,False
2011-05-19,14,3327,43,137,180,False
2011-05-19,15,3328,63,125,188,False
2011-05-19,16,3329,55,247,302,False
2011-05-19,17,3330,60,487,547,False
2011-05-19,18,3331,59,454,513,False
2011-05-19,19,3332,65,345,410,False
2011-05-19,20,3333,46,236,282,False
2011-05-19,21,3334,29,180,209,False
2011-05-19,22,3335,11,68,79,False
2011-05-19,23,3336,9,63,72,False
2011-05-20,0,3337,15,33,48,False
2011-05-20,1,3338,8,17,25,False
2011-05-20,2,3339,4,4,8,False
2011-05-20,3,3340,1,4,5,False
2011-05-20,4,3341,1,4,5,False
2011-05-20,5,3342,0,28,28,False
2011-05-20,6,3343,15,102,117,False
2011-05-20,7,3344,30,289,319,False
2011-05-20,8,3345,41,476,517,False
2011-05-20,9,3346,35,199,234,False
2011-05-20,10,3347,44,104,148,False
2011-05-20,11,3348,63,133,196,False
2011-05-20,12,3349,69,186,255,False
2011-05-20,13,3350,60,172,232,False
2011-05-20,14,3351,66,131,197,False
2011-05-20,15,3352,74,168,242,False
2011-05-20,16,3353,61,269,330,False
2011-05-20,17,3354,71,483,554,False
2011-05-20,18,3355,79,394,473,False
2011-05-20,19,3356,49,253,302,False
2011-05-20,20,3357,40,180,220,False
2011-05-20,21,3358,40,155,195,False
2011-05-20,22,3359,28,124,152,False
2011-05-20,23,3360,15,100,115,False
2011-05-21,0,3361,20,78,98,False
2011-05-21,1,3362,8,64,72,False
2011-05-21,2,3363,5,35,40,False
2011-05-21,3,3364,7,12,19,False
2011-05-21,4,3365,1,6,7,False
2011-05-21,5,3366,1,4,5,False
2011-05-21,6,3367,6,22,28,False
2011-05-21,7,3368,10,33,43,False
2011-05-21,8,3369,29,97,126,False
2011-05-21,9,3370,60,165,225,False
2011-05-21,10,3371,122,201,323,False
2011-05-21,11,3372,173,245,418,False
2011-05-21,12,3373,222,271,493,False
2011-05-21,13,3374,191,271,462,False
2011-05-21,14,3375,187,269,456,False
2011-05-21,15,3376,232,274,506,False
2011-05-21,16,3377,204,267,471,False
2011-05-21,17,3378,191,253,444,False
2011-05-21,18,3379,191,253,444,False
2011-05-21,19,3380,117,184,301,False
2011-05-21,20,3381,84,164,248,False
2011-05-21,21,3382,77,150,227,False
2011-05-21,22,3383,78,126,204,False
2011-05-21,23,3384,42,103,145,False
2011-05-22,0,3385,31,100,131,False
2011-05-22,1,3386,17,81,98,False
2011-05-22,2,3387,18,50,68,False
2011-05-22,3,3388,10,23,33,False
2011-05-22,4,3389,3,9,12,False
2011-05-22,5,3390,1,5,6,False
2011-05-22,6,3391,5,13,18,False
2011-05-22,7,3392,13,27,40,False
2011-05-22,8,3393,29,65,94,False
2011-05-22,9,3394,59,130,189,False
2011-05-22,10,3395,135,170,305,False
2011-05-22,11,3396,164,209,373,False
2011-05-22,12,3397,146,255,401,False
2011-05-22,13,3398,180,275,455,False
2011-05-22,14,3399,125,191,316,False
2011-05-22,15,3400,110,221,331,False
2011-05-22,16,3401,72,201,273,False
2011-05-22,17,3402,93,213,306,False
2011-05-22,18,3403,120,238,358,False
2011-05-22,19,3404,107,193,300,False
2011-05-22,20,3405,57,174,231,False
2011-05-22,21,3406,27,109,136,False
2011-05-22,22,3407,35,86,121,False
2011-05-22,23,3408,19,46,65,False
2011-05-23,0,3409,23,18,41,False
2011-05-23,1,3410,4,5,9,False
2011-05-23,2,3411,2,3,5,False
2011-05-23,3,3412,0,4,4,False
2011-05-23,4,3413,2,2,4,False
2011-05-23,5,3414,0,11,11,False
2011-05-23,6,3415,4,92,96,False
2011-05-23,7,3416,13,223,236,False
2011-05-23,8,3417,50,359,409,False
2011-05-23,9,3418,36,131,167,False
2011-05-23,10,3419,49,72,121,False
2011-05-23,11,3420,73,107,180,False
2011-05-23,12,3421,65,139,204,False
2011-05-23,13,3422,49,155,204,False
2011-05-23,14,3423,57,130,187,False
2011-05-23,15,3424,57,119,176,False
2011-05-23,16,3425,56,223,279,False
2011-05-23,17,3426,56,373,429,False
2011-05-23,18,3427,68,385,453,False
2011-05-23,19,3428,56,302,358,False
2011-05-23,20,3429,39,271,310,False
2011-05-23,21,3430,33,155,188,False
2011-05-23,22,3431,25,106,131,False
2011-05-23,23,3432,19,53,72,False
2011-05-24,0,3433,12,23,35,False
2011-05-24,1,3434,6,9,15,False
2011-05-24,2,3435,2,8,10,False
2011-05-24,3,3436,0,2,2,False
2011-05-24,4,3437,1,3,4,False
2011-05-24,5,3438,2,22,24,False
2011-05-24,6,3439,10,102,112,False
2011-05-24,7,3440,26,288,314,False
2011-05-24,8,3441,31,403,434,False
2011-05-24,9,3442,27,111,138,False
2011-05-24,10,3443,18,90,108,False
2011-05-24,11,3444,33,142,175,False
2011-05-24,12,3445,41,129,170,False
2011-05-24,13,3446,38,152,190,False
2011-05-24,14,3447,27,126,153,False
2011-05-24,15,3448,59,129,188,False
2011-05-24,16,3449,52,225,277,False
2011-05-24,17,3450,56,492,548,False
2011-05-24,18,3451,74,490,564,False
2011-05-24,19,3452,45,310,355,False
2011-05-24,20,3453,39,241,280,False
2011-05-24,21,3454,21,168,189,False
2011-05-24,22,3455,26,115,141,False
2011-05-24,23,3456,13,53,66,False
2011-05-25,0,3457,3,32,35,False
2011-05-25,1,3458,6,2,8,False
2011-05-25,2,3459,0,8,8,False
2011-05-25,3,3460,0,9,9,False
2011-05-25,4,3461,0,3,3,False
2011-05-25,5,3462,2,23,25,False
2011-05-25,6,3463,4,113,117,False
2011-05-25,7,3464,29,284,313,False
2011-05-25,8,3465,36,495,531,False
2011-05-25,9,3466,27,207,234,False
2011-05-25,10,3467,30,105,135,False
2011-05-25,11,3468,36,104,140,False
2011-05-25,12,3469,32,178,210,False
2011-05-25,13,3470,39,163,202,False
2011-05-25,14,3471,47,121,168,False
2011-05-25,15,3472,37,145,182,False
2011-05-25,16,3473,61,238,299,False
2011-05-25,17,3474,77,524,601,False
2011-05-25,18,3475,66,451,517,False
2011-05-25,19,3476,73,332,405,False
2011-05-25,20,3477,56,284,340,False
2011-05-25,21,3478,33,203,236,False
2011-05-25,22,3479,34,140,174,False
2011-05-25,23,3480,12,74,86,False
2011-05-26,0,3481,11,34,45,False
2011-05-26,1,3482,3,13,16,False
2011-05-26,2,3483,7,7,14,False
2011-05-26,3,3484,0,4,4,False
2011-05-26,4,3485,0,2,2,False
2011-05-26,5,3486,2,25,27,False
2011-05-26,6,3487,4,94,98,False
2011-05-26,7,3488,16,270,286,False
2011-05-26,8,3489,31,458,489,False
2011-05-26,9,3490,22,194,216,False
2011-05-26,10,3491,49,94,143,False
2011-05-26,11,3492,36,124,160,False
2011-05-26,12,3493,53,141,194,False
2011-05-26,13,3494,52,145,197,False
2011-05-26,14,3495,44,145,189,False
2011-05-26,15,3496,40,101,141,False
2011-05-26,16,3497,58,233,291,False
2011-05-26,17,3498,49,445,494,False
2011-05-26,18,3499,74,404,478,False
2011-05-26,19,3500,67,311,378,False
2011-05-26,20,3501,55,267,322,False
2011-05-26,21,3502,45,178,223,False
2011-05-26,22,3503,23,157,180,False
2011-05-26,23,3504,17,73,90,False
2011-05-27,0,3505,14,55,69,False
2011-05-27,1,3506,14,36,50,False
2011-05-27,2,3507,6,12,18,False
2011-05-27,3,3508,1,11,12,False
2011-05-27,4,3509,2,5,7,False
2011-05-27,5,3510,2,29,31,False
2011-05-27,6,3511,8,73,81,False
2011-05-27,7,3512,20,229,249,False
2011-05-27,8,3513,25,393,418,False
2011-05-27,9,3514,37,190,227,False
2011-05-27,10,3515,42,111,153,False
2011-05-27,11,3516,40,126,166,False
2011-05-27,12,3517,53,190,243,False
2011-05-27,13,3518,51,158,209,False
2011-05-27,14,3519,51,188,239,False
2011-05-27,15,3520,98,258,356,False
2011-05-27,16,3521,63,356,419,False
2011-05-27,17,3522,77,414,491,False
2011-05-27,18,3523,89,310,399,False
2011-05-27,19,3524,69,210,279,False
2011-05-27,20,3525,24,120,144,False
2011-05-27,21,3526,37,114,151,False
2011-05-27,22,3527,25,116,141,False
2011-05-27,23,3528,23,104,127,False
2011-05-28,0,3529,15,79,94,False
2011-05-28,1,3530,8,47,55,False
2011-05-28,2,3531,13,35,48,False
2011-05-28,3,3532,2,13,15,False
2011-05-28,4,3533,0,4,4,False
2011-05-28,5,3534,4,3,7,False
2011-05-28,6,3535,3,16,19,False
2011-05-28,7,3536,17,33,50,False
2011-05-28,8,3537,27,75,102,False
2011-05-28,9,3538,61,116,177,False
2011-05-28,10,3539,110,166,276,False
2011-05-28,11,3540,171,178,349,False
2011-05-28,12,3541,145,213,358,False
2011-05-28,13,3542,168,217,385,False
2011-05-28,14,3543,172,210,382,False
2011-05-28,15,3544,187,187,374,False
2011-05-28,16,3545,201,201,402,False
2011-05-28,17,3546,180,161,341,False
2011-05-28,18,3547,173,212,385,False
2011-05-28,19,3548,99,153,252,False
2011-05-28,20,3549,68,128,196,False
2011-05-28,21,3550,87,114,201,False
2011-05-28,22,3551,46,115,161,False
2011-05-28,23,3552,44,81,125,False
2011-05-29,0,3553,32,51,83,False
2011-05-29,1,3554,17,49,66,False
2011-05-29,2,3555,12,49,61,False
2011-05-29,3,3556,2,24,26,False
2011-05-29,4,3557,13,10,23,False
2011-05-29,5,3558,3,3,6,False
2011-05-29,6,3559,5,10,15,False
2011-05-29,7,3560,13,17,30,False
2011-05-29,8,3561,34,62,96,False
2011-05-29,9,3562,74,78,152,False
2011-05-29,10,3563,130,121,251,False
2011-05-29,11,3564,139,180,319,False
2011-05-29,12,3565,216,186,402,False
2011-05-29,13,3566,237,181,418,False
2011-05-29,14,3567,183,168,351,False
2011-05-29,15,3568,221,155,376,False
2011-05-29,16,3569,194,167,361,False
2011-05-29,17,3570,214,169,383,False
2011-05-29,18,3571,151,177,328,False
2011-05-29,19,3572,141,146,287,False
2011-05-29,20,3573,91,128,219,False
2011-05-29,21,3574,107,122,229,False
2011-05-29,22,3575,78,93,171,False
2011-05-29,23,3576,48,87,135,False
2011-05-30,0,3577,38,65,103,False
2011-05-30,1,3578,26,53,79,False
2011-05-30,2,3579,17,28,45,False
2011-05-30,3,3580,10,8,18,False
2011-05-30,4,3581,2,4,6,False
2011-05-30,5,3582,1,6,7,False
2011-05-30,6,3583,6,10,16,False
2011-05-30,7,3584,12,19,31,False
2011-05-30,8,3585,36,58,94,False
2011-05-30,9,3586,47,81,128,False
2011-05-30,10,3587,116,153,269,False
2011-05-30,11,3588,153,168,321,False
2011-05-30,12,3589,179,187,366,False
2011-05-30,13,3590,133,217,350,False
2011-05-30,14,3591,142,185,327,False
2011-05-30,15,3592,132,179,311,False
2011-05-30,16,3593,101,208,309,False
2011-05-30,17,3594,102,202,304,False
2011-05-30,18,3595,77,172,249,False
2011-05-30,19,3596,68,157,225,False
2011-05-30,20,3597,69,168,237,False
2011-05-30,21,3598,42,107,149,False
2011-05-30,22,3599,26,80,106,False
2011-05-30,23,3600,14,34,48,False
2011-05-31,0,3601,9,20,29,False
2011-05-31,1,3602,8,9,17,False
2011-05-31,2,3603,5,7,12,False
2011-05-31,3,3604,1,3,4,False
2011-05-31,4,3605,0,3,3,False
2011-05-31,5,3606,0,26,26,False
2011-05-31,6,3607,11,98,109,False
2011-05-31,7,3608,16,219,235,False
2011-05-31,8,3609,34,372,406,False
2011-05-31,9,3610,22,153,175,False
2011-05-31,10,3611,37,72,109,False
2011-05-31,11,3612,28,78,106,False
2011-05-31,12,3613,37,125,162,False
2011-05-31,13,3614,37,110,147,False
2011-05-31,14,3615,41,99,140,False
2011-05-31,15,3616,42,133,175,False
2011-05-31,16,3617,44,205,249,False
2011-05-31,17,3618,67,428,495,False
2011-05-31,18,3619,55,362,417,False
2011-05-31,19,3620,39,246,285,False
2011-05-31,20,3621,38,213,251,False
2011-05-31,21,3622,45,165,210,False
2011-05-31,22,3623,42,117,159,False
2011-05-31,23,3624,15,46,61,False
2011-06-01,0,3625,9,25,34,False
2011-06-01,1,3626,8,9,17,False
2011-06-01,2,3627,0,3,3,False
2011-06-01,3,3628,0,6,6,False
2011-06-01,4,3629,0,4,4,False
2011-06-01,5,3630,2,19,21,False
2011-06-01,6,3631,7,121,128,False
2011-06-01,7,3632,19,265,284,False
2011-06-01,8,3633,37,417,454,False
2011-06-01,9,3634,34,173,207,False
2011-06-01,10,3635,31,84,115,False
2011-06-01,11,3636,26,86,112,False
2011-06-01,12,3637,32,137,169,False
2011-06-01,13,3638,29,125,154,False
2011-06-01,14,3639,40,105,145,False
2011-06-01,15,3640,25,127,152,False
2011-06-01,16,3641,39,227,266,False
2011-06-01,17,3642,52,434,486,False
2011-06-01,18,3643,31,278,309,False
2011-06-01,19,3644,16,248,264,False
2011-06-01,20,3645,23,233,256,False
2011-06-01,21,3646,29,161,190,False
2011-06-01,22,3647,14,115,129,False
2011-06-01,23,3648,10,59,69,False
2011-06-02,0,3649,11,31,42,False
2011-06-02,1,3650,3,12,15,False
2011-06-02,2,3651,0,6,6,False
2011-06-02,3,3652,0,4,4,False
2011-06-02,4,3653,0,3,3,False
2011-06-02,5,3654,3,28,31,False
2011-06-02,6,3655,7,106,113,False
2011-06-02,7,3656,19,285,304,False
2011-06-02,8,3657,25,442,467,False
2011-06-02,9,3658,28,197,225,False
2011-06-02,10,3659,33,106,139,False
2011-06-02,11,3660,42,123,165,False
2011-06-02,12,3661,39,193,232,False
2011-06-02,13,3662,35,168,203,False
2011-06-02,14,3663,43,142,185,False
2011-06-02,15,3664,44,144,188,False
2011-06-02,16,3665,63,255,318,False
2011-06-02,17,3666,88,484,572,False
2011-06-02,18,3667,74,451,525,False
2011-06-02,19,3668,58,321,379,False
2011-06-02,20,3669,51,286,337,False
2011-06-02,21,3670,33,215,248,False
2011-06-02,22,3671,14,141,155,False
2011-06-02,23,3672,23,89,112,False
2011-06-03,0,3673,15,53,68,False
2011-06-03,1,3674,7,15,22,False
2011-06-03,2,3675,0,12,12,False
2011-06-03,3,3676,0,5,5,False
2011-06-03,4,3677,1,5,6,False
2011-06-03,5,3678,4,24,28,False
2011-06-03,6,3679,8,98,106,False
2011-06-03,7,3680,25,252,277,False
2011-06-03,8,3681,31,471,502,False
2011-06-03,9,3682,36,194,230,False
2011-06-03,10,3683,54,107,161,False
2011-06-03,11,3684,57,135,192,False
2011-06-03,12,3685,51,208,259,False
2011-06-03,13,3686,58,190,248,False
2011-06-03,14,3687,66,174,240,False
2011-06-03,15,3688,56,156,212,False
2011-06-03,16,3689,63,286,349,False
2011-06-03,17,3690,73,485,558,False
2011-06-03,18,3691,76,488,564,False
2011-06-03,19,3692,53,338,391,False
2011-06-03,20,3693,57,236,293,False
2011-06-03,21,3694,51,196,247,False
2011-06-03,22,3695,26,145,171,False
2011-06-03,23,3696,30,141,171,False
2011-06-04,0,3697,24,69,93,False
2011-06-04,1,3698,14,80,94,False
2011-06-04,2,3699,18,41,59,False
2011-06-04,3,3700,8,10,18,False
2011-06-04,4,3701,4,11,15,False
2011-06-04,5,3702,3,5,8,False
2011-06-04,6,3703,11,17,28,False
2011-06-04,7,3704,27,60,87,False
2011-06-04,8,3705,29,96,125,False
2011-06-04,9,3706,55,169,224,False
2011-06-04,10,3707,115,202,317,False
2011-06-04,11,3708,120,249,369,False
2011-06-04,12,3709,150,270,420,False
2011-06-04,13,3710,188,268,456,False
2011-06-04,14,3711,193,258,451,False
2011-06-04,15,3712,180,224,404,False
2011-06-04,16,3713,168,272,440,False
2011-06-04,17,3714,142,202,344,False
2011-06-04,18,3715,127,214,341,False
2011-06-04,19,3716,79,206,285,False
2011-06-04,20,3717,90,149,239,False
2011-06-04,21,3718,46,139,185,False
2011-06-04,22,3719,49,141,190,False
2011-06-04,23,3720,29,121,150,False
2011-06-05,0,3721,23,90,113,False
2011-06-05,1,3722,26,70,96,False
2011-06-05,2,3723,16,48,64,False
2011-06-05,3,3724,22,25,47,False
2011-06-05,4,3725,4,8,12,False
2011-06-05,5,3726,1,5,6,False
2011-06-05,6,3727,10,11,21,False
2011-06-05,7,3728,8,19,27,False
2011-06-05,8,3729,24,74,98,False
2011-06-05,9,3730,53,111,164,False
2011-06-05,10,3731,83,168,251,False
2011-06-05,11,3732,121,214,335,False
2011-06-05,12,3733,123,212,335,False
2011-06-05,13,3734,154,213,367,False
2011-06-05,14,3735,161,224,385,False
2011-06-05,15,3736,161,256,417,False
2011-06-05,16,3737,138,260,398,False
2011-06-05,17,3738,126,264,390,False
2011-06-05,18,3739,124,239,363,False
2011-06-05,19,3740,108,249,357,False
2011-06-05,20,3741,84,195,279,False
2011-06-05,21,3742,54,111,165,False
2011-06-05,22,3743,36,94,130,False
2011-06-05,23,3744,25,61,86,False
2011-06-06,0,3745,11,18,29,False
2011-06-06,1,3746,9,5,14,False
2011-06-06,2,3747,4,4,8,False
2011-06-06,3,3748,2,3,5,False
2011-06-06,4,3749,4,4,8,False
2011-06-06,5,3750,7,24,31,False
2011-06-06,6,3751,11,101,112,False
2011-06-06,7,3752,18,281,299,False
2011-06-06,8,3753,28,410,438,False
2011-06-06,9,3754,26,162,188,False
2011-06-06,10,3755,31,64,95,False
2011-06-06,11,3756,39,72,111,False
2011-06-06,12,3757,25,128,153,False
2011-06-06,13,3758,28,152,180,False
2011-06-06,14,3759,46,99,145,False
2011-06-06,15,3760,38,127,165,False
2011-06-06,16,3761,34,233,267,False
2011-06-06,17,3762,63,516,579,False
2011-06-06,18,3763,56,500,556,False
2011-06-06,19,3764,64,343,407,False
2011-06-06,20,3765,59,277,336,False
2011-06-06,21,3766,29,160,189,False
2011-06-06,22,3767,36,137,173,False
2011-06-06,23,3768,5,55,60,False
2011-06-07,0,3769,5,15,20,False
2011-06-07,1,3770,2,2,4,False
2011-06-07,2,3771,3,2,5,False
2011-06-07,3,3772,1,1,2,False
2011-06-07,4,3773,2,3,5,False
2011-06-07,5,3774,2,30,32,False
2011-06-07,6,3775,10,116,126,False
2011-06-07,7,3776,23,311,334,False
2011-06-07,8,3777,45,432,477,False
2011-06-07,9,3778,27,190,217,False
2011-06-07,10,3779,37,86,123,False
2011-06-07,11,3780,38,113,151,False
2011-06-07,12,3781,42,141,183,False
2011-06-07,13,3782,55,141,196,False
2011-06-07,14,3783,34,112,146,False
2011-06-07,15,3784,56,127,183,False
2011-06-07,16,3785,55,253,308,False
2011-06-07,17,3786,64,475,539,False
2011-06-07,18,3787,72,479,551,False
2011-06-07,19,3788,69,355,424,False
2011-06-07,20,3789,45,301,346,False
2011-06-07,21,3790,31,187,218,False
2011-06-07,22,3791,27,126,153,False
2011-06-07,23,3792,18,72,90,False
2011-06-08,0,3793,12,29,41,False
2011-06-08,1,3794,3,20,23,False
2011-06-08,2,3795,0,7,7,False
2011-06-08,3,3796,2,1,3,False
2011-06-08,4,3797,0,6,6,False
2011-06-08,5,3798,0,21,21,False
2011-06-08,6,3799,13,103,116,False
2011-06-08,7,3800,24,329,353,False
2011-06-08,8,3801,46,435,481,False
2011-06-08,9,3802,34,168,202,False
2011-06-08,10,3803,27,63,90,False
2011-06-08,11,3804,28,106,134,False
2011-06-08,12,3805,15,134,149,False
2011-06-08,13,3806,20,116,136,False
2011-06-08,14,3807,44,111,155,False
2011-06-08,15,3808,28,100,128,False
2011-06-08,16,3809,34,199,233,False
2011-06-08,17,3810,80,426,506,False
2011-06-08,18,3811,61,398,459,False
2011-06-08,19,3812,61,323,384,False
2011-06-08,20,3813,55,225,280,False
2011-06-08,21,3814,34,168,202,False
2011-06-08,22,3815,37,139,176,False
2011-06-08,23,3816,18,98,116,False
2011-06-09,0,3817,7,40,47,False
2011-06-09,1,3818,3,13,16,False
2011-06-09,2,3819,0,6,6,False
2011-06-09,3,3820,0,2,2,False
2011-06-09,4,3821,2,4,6,False
2011-06-09,5,3822,1,19,20,False
2011-06-09,6,3823,13,105,118,False
2011-06-09,7,3824,31,283,314,False
2011-06-09,8,3825,32,400,432,False
2011-06-09,9,3826,20,148,168,False
2011-06-09,10,3827,20,74,94,False
2011-06-09,11,3828,36,82,118,False
2011-06-09,12,3829,40,100,140,False
2011-06-09,13,3830,18,118,136,False
2011-06-09,14,3831,25,93,118,False
2011-06-09,15,3832,18,86,104,False
2011-06-09,16,3833,30,170,200,False
2011-06-09,17,3834,54,355,409,False
2011-06-09,18,3835,52,414,466,False
2011-06-09,19,3836,55,271,326,False
2011-06-09,20,3837,40,214,254,False
2011-06-09,21,3838,29,142,171,False
2011-06-09,22,3839,22,131,153,False
2011-06-09,23,3840,15,82,97,False
2011-06-10,0,3841,8,61,69,False
2011-06-10,1,3842,5,18,23,False
2011-06-10,2,3843,6,7,13,False
2011-06-10,3,3844,3,3,6,False
2011-06-10,4,3845,0,4,4,False
2011-06-10,5,3846,0,28,28,False
2011-06-10,6,3847,10,94,104,False
2011-06-10,7,3848,25,242,267,False
2011-06-10,8,3849,29,423,452,False
2011-06-10,9,3850,37,176,213,False
2011-06-10,10,3851,23,88,111,False
2011-06-10,11,3852,46,107,153,False
2011-06-10,12,3853,40,167,207,False
2011-06-10,13,3854,40,149,189,False
2011-06-10,14,3855,44,121,165,False
2011-06-10,15,3856,49,163,212,False
2011-06-10,16,3857,46,239,285,False
2011-06-10,17,3858,63,454,517,False
2011-06-10,18,3859,96,367,463,False
2011-06-10,19,3860,61,245,306,False
2011-06-10,20,3861,53,197,250,False
2011-06-10,21,3862,55,163,218,False
2011-06-10,22,3863,40,145,185,False
2011-06-10,23,3864,36,110,146,False
2011-06-11,0,3865,28,89,117,False
2011-06-11,1,3866,10,67,77,False
2011-06-11,2,3867,10,50,60,False
2011-06-11,3,3868,10,18,28,False
2011-06-11,4,3869,4,9,13,False
2011-06-11,5,3870,4,12,16,False
2011-06-11,6,3871,9,31,40,False
2011-06-11,7,3872,18,50,68,False
2011-06-11,8,3873,32,111,143,False
2011-06-11,9,3874,59,171,230,False
2011-06-11,10,3875,91,173,264,False
2011-06-11,11,3876,110,215,325,False
2011-06-11,12,3877,112,235,347,False
2011-06-11,13,3878,150,237,387,False
2011-06-11,14,3879,148,232,380,False
2011-06-11,15,3880,142,232,374,False
2011-06-11,16,3881,169,225,394,False
2011-06-11,17,3882,147,190,337,False
2011-06-11,18,3883,131,155,286,False
2011-06-11,19,3884,97,167,264,False
2011-06-11,20,3885,95,180,275,False
2011-06-11,21,3886,76,144,220,False
2011-06-11,22,3887,53,137,190,False
2011-06-11,23,3888,24,107,131,False
2011-06-12,0,3889,19,100,119,False
2011-06-12,1,3890,19,74,93,False
2011-06-12,2,3891,9,57,66,False
2011-06-12,3,3892,8,20,28,False
2011-06-12,4,3893,8,6,14,False
2011-06-12,5,3894,5,5,10,False
2011-06-12,6,3895,5,9,14,False
2011-06-12,7,3896,7,27,34,False
2011-06-12,8,3897,28,64,92,False
2011-06-12,9,3898,75,107,182,False
2011-06-12,10,3899,120,191,311,False
2011-06-12,11,3900,131,236,367,False
2011-06-12,12,3901,176,244,420,False
2011-06-12,13,3902,109,264,373,False
2011-06-12,14,3903,96,219,315,False
2011-06-12,15,3904,142,218,360,False
2011-06-12,16,3905,115,235,350,False
2011-06-12,17,3906,94,158,252,False
2011-06-12,18,3907,69,187,256,False
2011-06-12,19,3908,67,156,223,False
2011-06-12,20,3909,62,144,206,False
2011-06-12,21,3910,39,101,140,False
2011-06-12,22,3911,31,97,128,False
2011-06-12,23,3912,33,74,107,False
2011-06-13,0,3913,8,20,28,False
2011-06-13,1,3914,6,10,16,False
2011-06-13,2,3915,2,8,10,False
2011-06-13,3,3916,1,6,7,False
2011-06-13,4,3917,1,3,4,False
2011-06-13,5,3918,2,27,29,False
2011-06-13,6,3919,7,98,105,False
2011-06-13,7,3920,26,302,328,False
2011-06-13,8,3921,44,432,476,False
2011-06-13,9,3922,35,189,224,False
2011-06-13,10,3923,38,80,118,False
2011-06-13,11,3924,53,106,159,False
2011-06-13,12,3925,35,161,196,False
2011-06-13,13,3926,53,174,227,False
2011-06-13,14,3927,55,145,200,False
2011-06-13,15,3928,58,127,185,False
2011-06-13,16,3929,64,262,326,False
2011-06-13,17,3930,72,529,601,False
2011-06-13,18,3931,76,510,586,False
2011-06-13,19,3932,75,348,423,False
2011-06-13,20,3933,78,253,331,False
2011-06-13,21,3934,40,178,218,False
2011-06-13,22,3935,20,114,134,False
2011-06-13,23,3936,14,75,89,False
2011-06-14,0,3937,13,18,31,False
2011-06-14,1,3938,3,10,13,False
2011-06-14,2,3939,2,8,10,False
2011-06-14,3,3940,1,1,2,False
2011-06-14,4,3941,0,3,3,False
2011-06-14,5,3942,3,23,26,False
2011-06-14,6,3943,6,107,113,False
2011-06-14,7,3944,19,346,365,False
2011-06-14,8,3945,45,441,486,False
2011-06-14,9,3946,19,174,193,False
2011-06-14,10,3947,33,97,130,False
2011-06-14,11,3948,40,103,143,False
2011-06-14,12,3949,30,139,169,False
2011-06-14,13,3950,33,176,209,False
2011-06-14,14,3951,41,118,159,False
2011-06-14,15,3952,42,136,178,False
2011-06-14,16,3953,51,279,330,False
2011-06-14,17,3954,85,484,569,False
2011-06-14,18,3955,65,473,538,False
2011-06-14,19,3956,51,335,386,False
2011-06-14,20,3957,60,237,297,False
2011-06-14,21,3958,37,206,243,False
2011-06-14,22,3959,29,159,188,False
2011-06-14,23,3960,19,91,110,False
2011-06-15,0,3961,8,44,52,False
2011-06-15,1,3962,0,14,14,False
2011-06-15,2,3963,0,9,9,False
2011-06-15,3,3964,0,1,1,False
2011-06-15,4,3965,0,4,4,False
2011-06-15,5,3966,1,20,21,False
2011-06-15,6,3967,11,110,121,False
2011-06-15,7,3968,22,348,370,False
2011-06-15,8,3969,53,445,498,False
2011-06-15,9,3970,22,185,207,False
2011-06-15,10,3971,27,108,135,False
2011-06-15,11,3972,49,115,164,False
2011-06-15,12,3973,33,178,211,False
2011-06-15,13,3974,43,146,189,False
2011-06-15,14,3975,50,128,178,False
2011-06-15,15,3976,33,131,164,False
2011-06-15,16,3977,47,265,312,False
2011-06-15,17,3978,83,555,638,False
2011-06-15,18,3979,80,527,607,False
2011-06-15,19,3980,54,362,416,False
2011-06-15,20,3981,57,273,330,False
2011-06-15,21,3982,48,209,257,False
2011-06-15,22,3983,31,144,175,False
2011-06-15,23,3984,17,90,107,False
2011-06-16,0,3985,9,38,47,False
2011-06-16,1,3986,4,13,17,False
2011-06-16,2,3987,1,4,5,False
2011-06-16,3,3988,0,4,4,False
2011-06-16,4,3989,0,6,6,False
2011-06-16,5,3990,7,18,25,False
2011-06-16,6,3991,8,104,112,False
2011-06-16,7,3992,16,172,188,False
2011-06-16,8,3993,24,364,388,False
2011-06-16,9,3994,29,232,261,False
2011-06-16,10,3995,18,103,121,False
2011-06-16,11,3996,33,117,150,False
2011-06-16,12,3997,41,165,206,False
2011-06-16,13,3998,37,114,151,False
2011-06-16,14,3999,39,114,153,False
2011-06-16,15,4000,32,127,159,False
2011-06-16,16,4001,36,258,294,False
2011-06-16,17,4002,42,230,272,False
2011-06-16,18,4003,26,299,325,False
2011-06-16,19,4004,58,269,327,False
2011-06-16,20,4005,25,176,201,False
2011-06-16,21,4006,34,154,188,False
2011-06-16,22,4007,24,127,151,False
2011-06-16,23,4008,2,14,16,False
2011-06-17,0,4009,3,21,24,False
2011-06-17,1,4010,4,19,23,False
2011-06-17,2,4011,2,11,13,False
2011-06-17,3,4012,1,5,6,False
2011-06-17,4,4013,1,5,6,False
2011-06-17,5,4014,1,12,13,False
2011-06-17,6,4015,8,89,97,False
2011-06-17,7,4016,25,225,250,False
2011-06-17,8,4017,28,426,454,False
2011-06-17,9,4018,28,196,224,False
2011-06-17,10,4019,44,126,170,False
2011-06-17,11,4020,43,138,181,False
2011-06-17,12,4021,49,194,243,False
2011-06-17,13,4022,48,156,204,False
2011-06-17,14,4023,73,142,215,False
2011-06-17,15,4024,62,181,243,False
2011-06-17,16,4025,69,286,355,False
2011-06-17,17,4026,85,467,552,False
2011-06-17,18,4027,62,388,450,False
2011-06-17,19,4028,53,275,328,False
2011-06-17,20,4029,40,192,232,False
2011-06-17,21,4030,49,159,208,False
2011-06-17,22,4031,48,127,175,False
2011-06-17,23,4032,37,141,178,False
2011-06-18,0,4033,21,83,104,False
2011-06-18,1,4034,15,80,95,False
2011-06-18,2,4035,16,37,53,False
2011-06-18,3,4036,4,16,20,False
2011-06-18,4,4037,1,4,5,False
2011-06-18,5,4038,1,6,7,False
2011-06-18,6,4039,9,18,27,False
2011-06-18,7,4040,12,45,57,False
2011-06-18,8,4041,28,103,131,False
2011-06-18,9,4042,62,156,218,False
2011-06-18,10,4043,68,176,244,False
2011-06-18,11,4044,134,270,404,False
2011-06-18,12,4045,162,258,420,False
2011-06-18,13,4046,135,192,327,False
2011-06-18,14,4047,138,196,334,False
2011-06-18,15,4048,153,214,367,False
2011-06-18,16,4049,193,275,468,False
2011-06-18,17,4050,210,239,449,False
2011-06-18,18,4051,118,263,381,False
2011-06-18,19,4052,99,227,326,False
2011-06-18,20,4053,61,127,188,False
2011-06-18,21,4054,58,125,183,False
2011-06-18,22,4055,56,105,161,False
2011-06-18,23,4056,53,97,150,False
2011-06-19,0,4057,18,71,89,False
2011-06-19,1,4058,17,59,76,False
2011-06-19,2,4059,13,59,72,False
2011-06-19,3,4060,14,16,30,False
2011-06-19,4,4061,7,10,17,False
2011-06-19,5,4062,7,12,19,False
2011-06-19,6,4063,11,22,33,False
2011-06-19,7,4064,35,36,71,False
2011-06-19,8,4065,25,59,84,False
2011-06-19,9,4066,58,111,169,False
2011-06-19,10,4067,86,158,244,False
2011-06-19,11,4068,141,236,377,False
2011-06-19,12,4069,141,255,396,False
2011-06-19,13,4070,149,214,363,False
2011-06-19,14,4071,124,193,317,False
2011-06-19,15,4072,146,216,362,False
2011-06-19,16,4073,121,257,378,False
2011-06-19,17,4074,159,238,397,False
2011-06-19,18,4075,78,218,296,False
2011-06-19,19,4076,94,217,311,False
2011-06-19,20,4077,86,146,232,False
2011-06-19,21,4078,57,110,167,False
2011-06-19,22,4079,38,114,152,False
2011-06-19,23,4080,14,78,92,False
2011-06-20,0,4081,7,19,26,False
2011-06-20,1,4082,9,3,12,False
2011-06-20,2,4083,2,0,2,False
2011-06-20,3,4084,1,0,1,False
2011-06-20,4,4085,1,2,3,False
2011-06-20,5,4086,0,3,3,False
2011-06-20,6,4087,1,25,26,False
2011-06-20,7,4088,0,46,46,False
2011-06-20,8,4089,12,209,221,False
2011-06-20,9,4090,19,200,219,False
2011-06-20,10,4091,33,58,91,False
2011-06-20,11,4092,27,67,94,False
2011-06-20,12,4093,33,129,162,False
2011-06-20,13,4094,50,129,179,False
2011-06-20,14,4095,45,130,175,False
2011-06-20,15,4096,66,139,205,False
2011-06-20,16,4097,61,238,299,False
2011-06-20,17,4098,81,484,565,False
2011-06-20,18,4099,64,474,538,False
2011-06-20,19,4100,62,369,431,False
2011-06-20,20,4101,52,264,316,False
2011-06-20,21,4102,39,167,206,False
2011-06-20,22,4103,24,106,130,False
2011-06-20,23,4104,10,50,60,False
2011-06-21,0,4105,10,23,33,False
2011-06-21,1,4106,2,12,14,False
2011-06-21,2,4107,1,5,6,False
2011-06-21,3,4108,0,2,2,False
2011-06-21,4,4109,2,7,9,False
2011-06-21,5,4110,3,22,25,False
2011-06-21,6,4111,8,107,115,False
2011-06-21,7,4112,21,288,309,False
2011-06-21,8,4113,33,368,401,False
2011-06-21,9,4114,32,243,275,False
2011-06-21,10,4115,41,120,161,False
2011-06-21,11,4116,52,119,171,False
2011-06-21,12,4117,40,149,189,False
2011-06-21,13,4118,49,158,207,False
2011-06-21,14,4119,44,108,152,False
2011-06-21,15,4120,42,128,170,False
2011-06-21,16,4121,62,273,335,False
2011-06-21,17,4122,65,507,572,False
2011-06-21,18,4123,67,469,536,False
2011-06-21,19,4124,67,358,425,False
2011-06-21,20,4125,72,254,326,False
2011-06-21,21,4126,38,191,229,False
2011-06-21,22,4127,12,97,109,False
2011-06-21,23,4128,11,53,64,False
2011-06-22,0,4129,15,18,33,False
2011-06-22,1,4130,2,19,21,False
2011-06-22,2,4131,2,5,7,False
2011-06-22,3,4132,0,7,7,False
2011-06-22,4,4133,3,8,11,False
2011-06-22,5,4134,2,21,23,False
2011-06-22,6,4135,12,110,122,False
2011-06-22,7,4136,23,288,311,False
2011-06-22,8,4137,27,396,423,False
2011-06-22,9,4138,14,205,219,False
2011-06-22,10,4139,31,104,135,False
2011-06-22,11,4140,37,108,145,False
2011-06-22,12,4141,44,144,188,False
2011-06-22,13,4142,34,113,147,False
2011-06-22,14,4143,32,113,145,False
2011-06-22,15,4144,32,114,146,False
2011-06-22,16,4145,34,224,258,False
2011-06-22,17,4146,67,462,529,False
2011-06-22,18,4147,66,447,513,False
2011-06-22,19,4148,62,280,342,False
2011-06-22,20,4149,52,230,282,False
2011-06-22,21,4150,31,216,247,False
2011-06-22,22,4151,25,123,148,False
2011-06-22,23,4152,14,91,105,False
2011-06-23,0,4153,5,44,49,False
2011-06-23,1,4154,5,26,31,False
2011-06-23,2,4155,0,4,4,False
2011-06-23,3,4156,1,4,5,False
2011-06-23,4,4157,0,7,7,False
2011-06-23,5,4158,2,22,24,False
2011-06-23,6,4159,8,92,100,False
2011-06-23,7,4160,26,301,327,False
2011-06-23,8,4161,20,412,432,False
2011-06-23,9,4162,33,194,227,False
2011-06-23,10,4163,39,88,127,False
2011-06-23,11,4164,28,108,136,False
2011-06-23,12,4165,30,130,160,False
2011-06-23,13,4166,37,149,186,False
2011-06-23,14,4167,46,103,149,False
2011-06-23,15,4168,62,127,189,False
2011-06-23,16,4169,58,217,275,False
2011-06-23,17,4170,74,495,569,False
2011-06-23,18,4171,57,483,540,False
2011-06-23,19,4172,56,344,400,False
2011-06-23,20,4173,75,277,352,False
2011-06-23,21,4174,46,188,234,False
2011-06-23,22,4175,23,139,162,False
2011-06-23,23,4176,15,90,105,False
2011-06-24,0,4177,10,53,63,False
2011-06-24,1,4178,8,20,28,False
2011-06-24,2,4179,4,10,14,False
2011-06-24,3,4180,1,4,5,False
2011-06-24,4,4181,1,8,9,False
2011-06-24,5,4182,2,18,20,False
2011-06-24,6,4183,4,87,91,False
2011-06-24,7,4184,21,247,268,False
2011-06-24,8,4185,27,439,466,False
2011-06-24,9,4186,28,203,231,False
2011-06-24,10,4187,43,102,145,False
2011-06-24,11,4188,56,147,203,False
2011-06-24,12,4189,51,150,201,False
2011-06-24,13,4190,43,178,221,False
2011-06-24,14,4191,67,162,229,False
2011-06-24,15,4192,69,147,216,False
2011-06-24,16,4193,80,247,327,False
2011-06-24,17,4194,85,472,557,False
2011-06-24,18,4195,87,365,452,False
2011-06-24,19,4196,92,293,385,False
2011-06-24,20,4197,66,222,288,False
2011-06-24,21,4198,50,183,233,False
2011-06-24,22,4199,41,126,167,False
2011-06-24,23,4200,33,139,172,False
2011-06-25,0,4201,19,97,116,False
2011-06-25,1,4202,20,75,95,False
2011-06-25,2,4203,8,51,59,False
2011-06-25,3,4204,18,21,39,False
2011-06-25,4,4205,7,4,11,False
2011-06-25,5,4206,6,8,14,False
2011-06-25,6,4207,12,17,29,False
2011-06-25,7,4208,7,35,42,False
2011-06-25,8,4209,27,85,112,False
2011-06-25,9,4210,47,139,186,False
2011-06-25,10,4211,99,203,302,False
2011-06-25,11,4212,122,209,331,False
2011-06-25,12,4213,140,252,392,False
2011-06-25,13,4214,140,231,371,False
2011-06-25,14,4215,151,232,383,False
2011-06-25,15,4216,157,235,392,False
2011-06-25,16,4217,175,235,410,False
2011-06-25,17,4218,152,247,399,False
2011-06-25,18,4219,108,199,307,False
2011-06-25,19,4220,121,254,375,False
2011-06-25,20,4221,74,195,269,False
2011-06-25,21,4222,62,140,202,False
2011-06-25,22,4223,61,126,187,False
2011-06-25,23,4224,49,130,179,False
2011-06-26,0,4225,30,85,115,False
2011-06-26,1,4226,17,73,90,False
2011-06-26,2,4227,17,70,87,False
2011-06-26,3,4228,12,22,34,False
2011-06-26,4,4229,3,8,11,False
2011-06-26,5,4230,3,9,12,False
2011-06-26,6,4231,7,13,20,False
2011-06-26,7,4232,24,27,51,False
2011-06-26,8,4233,29,78,107,False
2011-06-26,9,4234,75,131,206,False
2011-06-26,10,4235,136,196,332,False
2011-06-26,11,4236,127,219,346,False
2011-06-26,12,4237,175,268,443,False
2011-06-26,13,4238,197,245,442,False
2011-06-26,14,4239,197,246,443,False
2011-06-26,15,4240,174,229,403,False
2011-06-26,16,4241,177,278,455,False
2011-06-26,17,4242,178,243,421,False
2011-06-26,18,4243,117,265,382,False
2011-06-26,19,4244,89,228,317,False
2011-06-26,20,4245,55,158,213,False
2011-06-26,21,4246,48,135,183,False
2011-06-26,22,4247,19,95,114,False
2011-06-26,23,4248,14,64,78,False
2011-06-27,0,4249,7,25,32,False
2011-06-27,1,4250,4,11,15,False
2011-06-27,2,4251,3,3,6,False
2011-06-27,3,4252,0,2,2,False
2011-06-27,4,4253,1,8,9,False
2011-06-27,5,4254,1,21,22,False
2011-06-27,6,4255,4,90,94,False
2011-06-27,7,4256,14,247,261,False
2011-06-27,8,4257,29,418,447,False
2011-06-27,9,4258,37,150,187,False
2011-06-27,10,4259,55,95,150,False
2011-06-27,11,4260,55,95,150,False
2011-06-27,12,4261,40,130,170,False
2011-06-27,13,4262,37,127,164,False
2011-06-27,14,4263,58,100,158,False
2011-06-27,15,4264,76,126,202,False
2011-06-27,16,4265,53,222,275,False
2011-06-27,17,4266,90,514,604,False
2011-06-27,18,4267,79,512,591,False
2011-06-27,19,4268,56,340,396,False
2011-06-27,20,4269,54,251,305,False
2011-06-27,21,4270,52,190,242,False
2011-06-27,22,4271,33,112,145,False
2011-06-27,23,4272,16,65,81,False
2011-06-28,0,4273,5,25,30,False
2011-06-28,1,4274,5,8,13,False
2011-06-28,2,4275,2,9,11,False
2011-06-28,3,4276,0,2,2,False
2011-06-28,4,4277,1,7,8,False
2011-06-28,5,4278,1,20,21,False
2011-06-28,6,4279,7,117,124,False
2011-06-28,7,4280,27,320,347,False
2011-06-28,8,4281,39,417,456,False
2011-06-28,9,4282,38,208,246,False
2011-06-28,10,4283,45,112,157,False
2011-06-28,11,4284,49,118,167,False
2011-06-28,12,4285,41,161,202,False
2011-06-28,13,4286,33,156,189,False
2011-06-28,14,4287,43,117,160,False
2011-06-28,15,4288,39,127,166,False
2011-06-28,16,4289,41,220,261,False
2011-06-28,17,4290,70,509,579,False
2011-06-28,18,4291,68,436,504,False
2011-06-28,19,4292,44,255,299,False
2011-06-28,20,4293,50,246,296,False
2011-06-28,21,4294,31,164,195,False
2011-06-28,22,4295,30,104,134,False
2011-06-28,23,4296,23,58,81,False
2011-06-29,0,4297,11,25,36,False
2011-06-29,1,4298,10,18,28,False
2011-06-29,2,4299,7,9,16,False
2011-06-29,3,4300,2,3,5,False
2011-06-29,4,4301,0,5,5,False
2011-06-29,5,4302,3,19,22,False
2011-06-29,6,4303,12,104,116,False
2011-06-29,7,4304,18,318,336,False
2011-06-29,8,4305,41,499,540,False
2011-06-29,9,4306,32,189,221,False
2011-06-29,10,4307,31,95,126,False
2011-06-29,11,4308,53,117,170,False
2011-06-29,12,4309,55,188,243,False
2011-06-29,13,4310,45,186,231,False
2011-06-29,14,4311,50,138,188,False
2011-06-29,15,4312,43,146,189,False
2011-06-29,16,4313,60,268,328,False
2011-06-29,17,4314,78,492,570,False
2011-06-29,18,4315,78,510,588,False
2011-06-29,19,4316,60,341,401,False
2011-06-29,20,4317,69,264,333,False
2011-06-29,21,4318,26,195,221,False
2011-06-29,22,4319,32,151,183,False
2011-06-29,23,4320,32,97,129,False
2011-06-30,0,4321,15,39,54,False
2011-06-30,1,4322,13,19,32,False
2011-06-30,2,4323,2,6,8,False
2011-06-30,3,4324,2,7,9,False
2011-06-30,4,4325,2,4,6,False
2011-06-30,5,4326,1,24,25,False
2011-06-30,6,4327,4,119,123,False
2011-06-30,7,4328,29,291,320,False
2011-06-30,8,4329,44,511,555,False
2011-06-30,9,4330,33,227,260,False
2011-06-30,10,4331,35,97,132,False
2011-06-30,11,4332,47,122,169,False
2011-06-30,12,4333,50,183,233,False
2011-06-30,13,4334,70,162,232,False
2011-06-30,14,4335,46,117,163,False
2011-06-30,15,4336,64,176,240,False
2011-06-30,16,4337,63,260,323,False
2011-06-30,17,4338,98,496,594,False
2011-06-30,18,4339,114,472,586,False
2011-06-30,19,4340,89,366,455,False
2011-06-30,20,4341,55,285,340,False
2011-06-30,21,4342,81,242,323,False
2011-06-30,22,4343,43,164,207,False
2011-06-30,23,4344,27,99,126,False
2011-07-01,0,4345,20,48,68,False
2011-07-01,1,4346,15,16,31,False
2011-07-01,2,4347,6,7,13,False
2011-07-01,3,4348,5,6,11,False
2011-07-01,4,4349,1,5,6,False
2011-07-01,5,4350,3,27,30,False
2011-07-01,6,4351,11,97,108,False
2011-07-01,7,4352,25,218,243,False
2011-07-01,8,4353,39,453,492,False
2011-07-01,9,4354,58,202,260,False
2011-07-01,10,4355,61,109,170,False
2011-07-01,11,4356,68,146,214,False
2011-07-01,12,4357,83,180,263,False
2011-07-01,13,4358,83,209,292,False
2011-07-01,14,4359,78,225,303,False
2011-07-01,15,4360,82,299,381,False
2011-07-01,16,4361,85,342,427,False
2011-07-01,17,4362,99,362,461,False
2011-07-01,18,4363,98,324,422,False
2011-07-01,19,4364,80,238,318,False
2011-07-01,20,4365,84,185,269,False
2011-07-01,21,4366,69,149,218,False
2011-07-01,22,4367,49,173,222,False
2011-07-01,23,4368,44,96,140,False
2011-07-02,0,4369,31,84,115,False
2011-07-02,1,4370,20,58,78,False
2011-07-02,2,4371,9,43,52,False
2011-07-02,3,4372,5,21,26,False
2011-07-02,4,4373,3,8,11,False
2011-07-02,5,4374,1,13,14,False
2011-07-02,6,4375,11,21,32,False
2011-07-02,7,4376,10,35,45,False
2011-07-02,8,4377,38,94,132,False
2011-07-02,9,4378,55,124,179,False
2011-07-02,10,4379,103,168,271,False
2011-07-02,11,4380,144,213,357,False
2011-07-02,12,4381,142,232,374,False
2011-07-02,13,4382,178,226,404,False
2011-07-02,14,4383,177,215,392,False
2011-07-02,15,4384,168,163,331,False
2011-07-02,16,4385,206,192,398,False
2011-07-02,17,4386,179,170,349,False
2011-07-02,18,4387,193,190,383,False
2011-07-02,19,4388,156,149,305,False
2011-07-02,20,4389,136,148,284,False
2011-07-02,21,4390,95,137,232,False
2011-07-02,22,4391,78,123,201,False
2011-07-02,23,4392,66,88,154,False
2011-07-03,0,4393,47,97,144,False
2011-07-03,1,4394,23,55,78,False
2011-07-03,2,4395,19,50,69,False
2011-07-03,3,4396,8,25,33,False
2011-07-03,4,4397,3,2,5,False
2011-07-03,5,4398,0,1,1,False
2011-07-03,6,4399,0,3,3,False
2011-07-03,7,4400,3,22,25,False
2011-07-03,8,4401,39,53,92,False
2011-07-03,9,4402,82,99,181,False
2011-07-03,10,4403,131,133,264,False
2011-07-03,11,4404,215,175,390,False
2011-07-03,12,4405,198,206,404,False
2011-07-03,13,4406,248,173,421,False
2011-07-03,14,4407,225,150,375,False
2011-07-03,15,4408,194,182,376,False
2011-07-03,16,4409,195,219,414,False
2011-07-03,17,4410,181,177,358,False
2011-07-03,18,4411,74,107,181,False
2011-07-03,19,4412,100,83,183,False
2011-07-03,20,4413,83,93,176,False
2011-07-03,21,4414,75,92,167,False
2011-07-03,22,4415,69,93,162,False
2011-07-03,23,4416,70,77,147,False
2011-07-04,0,4417,63,77,140,False
2011-07-04,1,4418,43,76,119,False
2011-07-04,2,4419,33,30,63,False
2011-07-04,3,4420,13,13,26,False
2011-07-04,4,4421,8,4,12,False
2011-07-04,5,4422,1,3,4,False
2011-07-04,6,4423,5,11,16,False
2011-07-04,7,4424,17,19,36,False
2011-07-04,8,4425,42,44,86,False
2011-07-04,9,4426,142,96,238,False
2011-07-04,10,4427,166,114,280,False
2011-07-04,11,4428,177,172,349,False
2011-07-04,12,4429,237,210,447,False
2011-07-04,13,4430,242,181,423,False
2011-07-04,14,4431,235,173,408,False
2011-07-04,15,4432,224,184,408,False
2011-07-04,16,4433,236,216,452,False
2011-07-04,17,4434,240,196,436,False
2011-07-04,18,4435,222,196,418,False
2011-07-04,19,4436,170,205,375,False
2011-07-04,20,4437,195,191,386,False
2011-07-04,21,4438,195,262,457,False
2011-07-04,22,4439,115,211,326,False
2011-07-04,23,4440,44,94,138,False
2011-07-05,0,4441,19,36,55,False
2011-07-05,1,4442,15,24,39,False
2011-07-05,2,4443,8,5,13,False
2011-07-05,3,4444,1,7,8,False
2011-07-05,4,4445,1,4,5,False
2011-07-05,5,4446,1,19,20,False
2011-07-05,6,4447,3,91,94,False
2011-07-05,7,4448,22,248,270,False
2011-07-05,8,4449,41,391,432,False
2011-07-05,9,4450,50,177,227,False
2011-07-05,10,4451,55,84,139,False
2011-07-05,11,4452,75,97,172,False
2011-07-05,12,4453,71,130,201,False
2011-07-05,13,4454,67,136,203,False
2011-07-05,14,4455,66,112,178,False
2011-07-05,15,4456,51,111,162,False
2011-07-05,16,4457,79,202,281,False
2011-07-05,17,4458,79,466,545,False
2011-07-05,18,4459,70,426,496,False
2011-07-05,19,4460,71,297,368,False
2011-07-05,20,4461,59,225,284,False
2011-07-05,21,4462,77,168,245,False
2011-07-05,22,4463,31,124,155,False
2011-07-05,23,4464,19,54,73,False
2011-07-06,0,4465,11,26,37,False
2011-07-06,1,4466,4,11,15,False
2011-07-06,2,4467,1,4,5,False
2011-07-06,3,4468,0,6,6,False
2011-07-06,4,4469,0,6,6,False
2011-07-06,5,4470,5,30,35,False
2011-07-06,6,4471,9,112,121,False
2011-07-06,7,4472,24,288,312,False
2011-07-06,8,4473,31,397,428,False
2011-07-06,9,4474,31,158,189,False
2011-07-06,10,4475,13,30,43,False
2011-07-06,11,4476,24,103,127,False
2011-07-06,12,4477,38,114,152,False
2011-07-06,13,4478,33,107,140,False
2011-07-06,14,4479,50,113,163,False
2011-07-06,15,4480,55,130,185,False
2011-07-06,16,4481,57,218,275,False
2011-07-06,17,4482,79,517,596,False
2011-07-06,18,4483,77,486,563,False
2011-07-06,19,4484,71,323,394,False
2011-07-06,20,4485,55,257,312,False
2011-07-06,21,4486,66,175,241,False
2011-07-06,22,4487,30,156,186,False
2011-07-06,23,4488,20,78,98,False
2011-07-07,0,4489,6,29,35,False
2011-07-07,1,4490,2,14,16,False
2011-07-07,2,4491,1,7,8,False
2011-07-07,3,4492,2,2,4,False
2011-07-07,4,4493,0,4,4,False
2011-07-07,5,4494,2,30,32,False
2011-07-07,6,4495,11,107,118,False
2011-07-07,7,4496,13,279,292,False
2011-07-07,8,4497,28,415,443,False
2011-07-07,9,4498,25,154,179,False
2011-07-07,10,4499,29,72,101,False
2011-07-07,11,4500,30,112,142,False
2011-07-07,12,4501,32,139,171,False
2011-07-07,13,4502,48,107,155,False
2011-07-07,14,4503,39,121,160,False
2011-07-07,15,4504,47,119,166,False
2011-07-07,16,4505,47,218,265,False
2011-07-07,17,4506,80,489,569,False
2011-07-07,18,4507,70,492,562,False
2011-07-07,19,4508,79,286,365,False
2011-07-07,20,4509,61,224,285,False
2011-07-07,21,4510,39,170,209,False
2011-07-07,22,4511,32,150,182,False
2011-07-07,23,4512,31,98,129,False
2011-07-08,0,4513,6,41,47,False
2011-07-08,1,4514,9,25,34,False
2011-07-08,2,4515,10,12,22,False
2011-07-08,3,4516,2,4,6,False
2011-07-08,4,4517,7,4,11,False
2011-07-08,5,4518,3,24,27,False
2011-07-08,6,4519,11,91,102,False
2011-07-08,7,4520,30,302,332,False
2011-07-08,8,4521,36,421,457,False
2011-07-08,9,4522,30,211,241,False
2011-07-08,10,4523,30,108,138,False
2011-07-08,11,4524,61,104,165,False
2011-07-08,12,4525,49,164,213,False
2011-07-08,13,4526,54,175,229,False
2011-07-08,14,4527,53,163,216,False
2011-07-08,15,4528,39,102,141,False
2011-07-08,16,4529,27,105,132,False
2011-07-08,17,4530,6,161,167,False
2011-07-08,18,4531,35,281,316,False
2011-07-08,19,4532,45,225,270,False
2011-07-08,20,4533,30,220,250,False
2011-07-08,21,4534,46,158,204,False
2011-07-08,22,4535,33,136,169,False
2011-07-08,23,4536,40,111,151,False
2011-07-09,0,4537,31,90,121,False
2011-07-09,1,4538,5,48,53,False
2011-07-09,2,4539,12,43,55,False
2011-07-09,3,4540,7,23,30,False
2011-07-09,4,4541,2,4,6,False
2011-07-09,5,4542,4,11,15,False
2011-07-09,6,4543,11,27,38,False
2011-07-09,7,4544,21,50,71,False
2011-07-09,8,4545,68,114,182,False
2011-07-09,9,4546,77,170,247,False
2011-07-09,10,4547,87,177,264,False
2011-07-09,11,4548,101,189,290,False
2011-07-09,12,4549,145,221,366,False
2011-07-09,13,4550,167,249,416,False
2011-07-09,14,4551,158,215,373,False
2011-07-09,15,4552,182,220,402,False
2011-07-09,16,4553,171,245,416,False
2011-07-09,17,4554,160,241,401,False
2011-07-09,18,4555,132,246,378,False
2011-07-09,19,4556,128,178,306,False
2011-07-09,20,4557,129,185,314,False
2011-07-09,21,4558,83,155,238,False
2011-07-09,22,4559,60,154,214,False
2011-07-09,23,4560,47,93,140,False
2011-07-10,0,4561,42,112,154,False
2011-07-10,1,4562,19,94,113,False
2011-07-10,2,4563,28,68,96,False
2011-07-10,3,4564,6,19,25,False
2011-07-10,4,4565,0,5,5,False
2011-07-10,5,4566,7,10,17,False
2011-07-10,6,4567,8,17,25,False
2011-07-10,7,4568,27,38,65,False
2011-07-10,8,4569,27,65,92,False
2011-07-10,9,4570,62,107,169,False
2011-07-10,10,4571,95,173,268,False
2011-07-10,11,4572,110,177,287,False
2011-07-10,12,4573,133,244,377,False
2011-07-10,13,4574,139,228,367,False
2011-07-10,14,4575,122,227,349,False
2011-07-10,15,4576,142,219,361,False
2011-07-10,16,4577,128,244,372,False
2011-07-10,17,4578,146,217,363,False
2011-07-10,18,4579,141,222,363,False
2011-07-10,19,4580,120,183,303,False
2011-07-10,20,4581,101,167,268,False
2011-07-10,21,4582,65,162,227,False
2011-07-10,22,4583,56,87,143,False
2011-07-10,23,4584,19,53,72,False
2011-07-11,0,4585,10,25,35,False
2011-07-11,1,4586,5,5,10,False
2011-07-11,2,4587,8,4,12,False
2011-07-11,3,4588,2,8,10,False
2011-07-11,4,4589,0,4,4,False
2011-07-11,5,4590,5,21,26,False
2011-07-11,6,4591,19,102,121,False
2011-07-11,7,4592,28,289,317,False
2011-07-11,8,4593,35,385,420,False
2011-07-11,9,4594,41,167,208,False
2011-07-11,10,4595,44,73,117,False
2011-07-11,11,4596,39,89,128,False
2011-07-11,12,4597,40,108,148,False
2011-07-11,13,4598,22,119,141,False
2011-07-11,14,4599,40,94,134,False
2011-07-11,15,4600,38,108,146,False
2011-07-11,16,4601,57,182,239,False
2011-07-11,17,4602,59,455,514,False
2011-07-11,18,4603,57,415,472,False
2011-07-11,19,4604,80,293,373,False
2011-07-11,20,4605,42,194,236,False
2011-07-11,21,4606,21,109,130,False
2011-07-11,22,4607,20,70,90,False
2011-07-11,23,4608,11,44,55,False
2011-07-12,0,4609,3,19,22,False
2011-07-12,1,4610,6,8,14,False
2011-07-12,2,4611,2,7,9,False
2011-07-12,3,4612,2,6,8,False
2011-07-12,4,4613,0,6,6,False
2011-07-12,5,4614,4,21,25,False
2011-07-12,6,4615,13,102,115,False
2011-07-12,7,4616,29,301,330,False
2011-07-12,8,4617,35,382,417,False
2011-07-12,9,4618,27,149,176,False
2011-07-12,10,4619,38,85,123,False
2011-07-12,11,4620,39,86,125,False
2011-07-12,12,4621,38,125,163,False
2011-07-12,13,4622,32,104,136,False
2011-07-12,14,4623,33,91,124,False
2011-07-12,15,4624,37,111,148,False
2011-07-12,16,4625,25,177,202,False
2011-07-12,17,4626,48,380,428,False
2011-07-12,18,4627,39,472,511,False
2011-07-12,19,4628,42,295,337,False
2011-07-12,20,4629,57,251,308,False
2011-07-12,21,4630,49,209,258,False
2011-07-12,22,4631,44,150,194,False
2011-07-12,23,4632,20,59,79,False
2011-07-13,0,4633,9,37,46,False
2011-07-13,1,4634,1,11,12,False
2011-07-13,2,4635,2,3,5,False
2011-07-13,3,4636,0,4,4,False
2011-07-13,4,4637,0,5,5,False
2011-07-13,5,4638,4,22,26,False
2011-07-13,6,4639,18,103,121,False
2011-07-13,7,4640,32,281,313,False
2011-07-13,8,4641,31,418,449,False
2011-07-13,9,4642,23,163,186,False
2011-07-13,10,4643,33,80,113,False
2011-07-13,11,4644,55,110,165,False
2011-07-13,12,4645,40,134,174,False
2011-07-13,13,4646,39,119,158,False
2011-07-13,14,4647,27,89,116,False
2011-07-13,15,4648,13,33,46,False
2011-07-13,16,4649,23,118,141,False
2011-07-13,17,4650,70,418,488,False
2011-07-13,18,4651,51,412,463,False
2011-07-13,19,4652,79,340,419,False
2011-07-13,20,4653,61,281,342,False
2011-07-13,21,4654,56,194,250,False
2011-07-13,22,4655,48,136,184,False
2011-07-13,23,4656,33,83,116,False
2011-07-14,0,4657,14,32,46,False
2011-07-14,1,4658,4,21,25,False
2011-07-14,2,4659,3,7,10,False
2011-07-14,3,4660,1,5,6,False
2011-07-14,4,4661,0,6,6,False
2011-07-14,5,4662,6,22,28,False
2011-07-14,6,4663,14,116,130,False
2011-07-14,7,4664,23,311,334,False
2011-07-14,8,4665,53,433,486,False
2011-07-14,9,4666,29,195,224,False
2011-07-14,10,4667,32,95,127,False
2011-07-14,11,4668,38,110,148,False
2011-07-14,12,4669,51,172,223,False
2011-07-14,13,4670,39,138,177,False
2011-07-14,14,4671,49,129,178,False
2011-07-14,15,4672,42,138,180,False
2011-07-14,16,4673,43,231,274,False
2011-07-14,17,4674,78,517,595,False
2011-07-14,18,4675,94,484,578,False
2011-07-14,19,4676,67,333,400,False
2011-07-14,20,4677,81,267,348,False
2011-07-14,21,4678,58,203,261,False
2011-07-14,22,4679,42,134,176,False
2011-07-14,23,4680,27,97,124,False
2011-07-15,0,4681,23,57,80,False
2011-07-15,1,4682,7,13,20,False
2011-07-15,2,4683,16,22,38,False
2011-07-15,3,4684,1,6,7,False
2011-07-15,4,4685,2,8,10,False
2011-07-15,5,4686,7,16,23,False
2011-07-15,6,4687,12,108,120,False
2011-07-15,7,4688,17,257,274,False
2011-07-15,8,4689,50,514,564,False
2011-07-15,9,4690,31,176,207,False
2011-07-15,10,4691,59,107,166,False
2011-07-15,11,4692,73,137,210,False
2011-07-15,12,4693,61,177,238,False
2011-07-15,13,4694,85,162,247,False
2011-07-15,14,4695,105,160,265,False
2011-07-15,15,4696,74,163,237,False
2011-07-15,16,4697,96,265,361,False
2011-07-15,17,4698,104,483,587,False
2011-07-15,18,4699,102,394,496,False
2011-07-15,19,4700,114,280,394,False
2011-07-15,20,4701,92,251,343,False
2011-07-15,21,4702,75,186,261,False
2011-07-15,22,4703,71,152,223,False
2011-07-15,23,4704,41,126,167,False
2011-07-16,0,4705,42,68,110,False
2011-07-16,1,4706,24,51,75,False
2011-07-16,2,4707,10,48,58,False
2011-07-16,3,4708,6,20,26,False
2011-07-16,4,4709,9,7,16,False
2011-07-16,5,4710,4,6,10,False
2011-07-16,6,4711,16,21,37,False
2011-07-16,7,4712,14,38,52,False
2011-07-16,8,4713,37,90,127,False
2011-07-16,9,4714,72,150,222,False
2011-07-16,10,4715,114,208,322,False
2011-07-16,11,4716,171,225,396,False
2011-07-16,12,4717,187,276,463,False
2011-07-16,13,4718,221,276,497,False
2011-07-16,14,4719,201,232,433,False
2011-07-16,15,4720,205,223,428,False
2011-07-16,16,4721,183,242,425,False
2011-07-16,17,4722,234,241,475,False
2011-07-16,18,4723,185,243,428,False
2011-07-16,19,4724,164,242,406,False
2011-07-16,20,4725,108,188,296,False
2011-07-16,21,4726,85,167,252,False
2011-07-16,22,4727,65,136,201,False
2011-07-16,23,4728,61,107,168,False
2011-07-17,0,4729,34,91,125,False
2011-07-17,1,4730,16,86,102,False
2011-07-17,2,4731,28,66,94,False
2011-07-17,3,4732,21,26,47,False
2011-07-17,4,4733,4,6,10,False
2011-07-17,5,4734,4,8,12,False
2011-07-17,6,4735,10,11,21,False
2011-07-17,7,4736,20,30,50,False
2011-07-17,8,4737,45,73,118,False
2011-07-17,9,4738,74,110,184,False
2011-07-17,10,4739,127,177,304,False
2011-07-17,11,4740,147,244,391,False
2011-07-17,12,4741,177,243,420,False
2011-07-17,13,4742,200,272,472,False
2011-07-17,14,4743,168,262,430,False
2011-07-17,15,4744,129,195,324,False
2011-07-17,16,4745,129,188,317,False
2011-07-17,17,4746,133,236,369,False
2011-07-17,18,4747,147,243,390,False
2011-07-17,19,4748,145,234,379,False
2011-07-17,20,4749,85,177,262,False
2011-07-17,21,4750,59,148,207,False
2011-07-17,22,4751,65,116,181,False
2011-07-17,23,4752,39,54,93,False
2011-07-18,0,4753,21,30,51,False
2011-07-18,1,4754,17,8,25,False
2011-07-18,2,4755,2,8,10,False
2011-07-18,3,4756,3,4,7,False
2011-07-18,4,4757,1,3,4,False
2011-07-18,5,4758,2,15,17,False
2011-07-18,6,4759,10,95,105,False
2011-07-18,7,4760,22,255,277,False
2011-07-18,8,4761,18,329,347,False
2011-07-18,9,4762,33,170,203,False
2011-07-18,10,4763,52,78,130,False
2011-07-18,11,4764,42,99,141,False
2011-07-18,12,4765,39,126,165,False
2011-07-18,13,4766,27,125,152,False
2011-07-18,14,4767,32,106,138,False
2011-07-18,15,4768,53,111,164,False
2011-07-18,16,4769,45,220,265,False
2011-07-18,17,4770,72,473,545,False
2011-07-18,18,4771,80,478,558,False
2011-07-18,19,4772,63,335,398,False
2011-07-18,20,4773,91,232,323,False
2011-07-18,21,4774,48,154,202,False
2011-07-18,22,4775,36,104,140,False
2011-07-18,23,4776,32,59,91,False
2011-07-19,0,4777,25,26,51,False
2011-07-19,1,4778,7,6,13,False
2011-07-19,2,4779,9,4,13,False
2011-07-19,3,4780,2,1,3,False
2011-07-19,4,4781,1,4,5,False
2011-07-19,5,4782,0,19,19,False
2011-07-19,6,4783,8,126,134,False
2011-07-19,7,4784,28,287,315,False
2011-07-19,8,4785,31,381,412,False
2011-07-19,9,4786,22,177,199,False
2011-07-19,10,4787,29,112,141,False
2011-07-19,11,4788,29,98,127,False
2011-07-19,12,4789,26,127,153,False
2011-07-19,13,4790,33,139,172,False
2011-07-19,14,4791,41,111,152,False
2011-07-19,15,4792,48,110,158,False
2011-07-19,16,4793,61,216,277,False
2011-07-19,17,4794,68,445,513,False
2011-07-19,18,4795,80,450,530,False
2011-07-19,19,4796,54,334,388,False
2011-07-19,20,4797,48,229,277,False
2011-07-19,21,4798,47,194,241,False
2011-07-19,22,4799,36,120,156,False
2011-07-19,23,4800,19,73,92,False
2011-07-20,0,4801,11,29,40,False
2011-07-20,1,4802,4,7,11,False
2011-07-20,2,4803,2,7,9,False
2011-07-20,3,4804,2,4,6,False
2011-07-20,4,4805,0,4,4,False
2011-07-20,5,4806,4,19,23,False
2011-07-20,6,4807,5,111,116,False
2011-07-20,7,4808,27,276,303,False
2011-07-20,8,4809,34,404,438,False
2011-07-20,9,4810,28,181,209,False
2011-07-20,10,4811,34,76,110,False
2011-07-20,11,4812,26,116,142,False
2011-07-20,12,4813,28,121,149,False
2011-07-20,13,4814,23,97,120,False
2011-07-20,14,4815,44,83,127,False
2011-07-20,15,4816,36,102,138,False
2011-07-20,16,4817,30,204,234,False
2011-07-20,17,4818,50,405,455,False
2011-07-20,18,4819,68,429,497,False
2011-07-20,19,4820,59,323,382,False
2011-07-20,20,4821,45,264,309,False
2011-07-20,21,4822,33,209,242,False
2011-07-20,22,4823,25,144,169,False
2011-07-20,23,4824,26,73,99,False
2011-07-21,0,4825,13,29,42,False
2011-07-21,1,4826,5,16,21,False
2011-07-21,2,4827,2,4,6,False
2011-07-21,3,4828,1,5,6,False
2011-07-21,4,4829,0,4,4,False
2011-07-21,5,4830,2,16,18,False
2011-07-21,6,4831,6,111,117,False
2011-07-21,7,4832,23,251,274,False
2011-07-21,8,4833,23,358,381,False
2011-07-21,9,4834,34,166,200,False
2011-07-21,10,4835,31,47,78,False
2011-07-21,11,4836,27,79,106,False
2011-07-21,12,4837,29,106,135,False
2011-07-21,13,4838,21,81,102,False
2011-07-21,14,4839,50,97,147,False
2011-07-21,15,4840,40,93,133,False
2011-07-21,16,4841,43,167,210,False
2011-07-21,17,4842,40,374,414,False
2011-07-21,18,4843,39,343,382,False
2011-07-21,19,4844,51,233,284,False
2011-07-21,20,4845,38,199,237,False
2011-07-21,21,4846,38,187,225,False
2011-07-21,22,4847,36,113,149,False
2011-07-21,23,4848,40,73,113,False
2011-07-22,0,4849,9,51,60,False
2011-07-22,1,4850,7,17,24,False
2011-07-22,2,4851,0,14,14,False
2011-07-22,3,4852,1,6,7,False
2011-07-22,4,4853,8,5,13,False
2011-07-22,5,4854,2,17,19,False
2011-07-22,6,4855,13,83,96,False
2011-07-22,7,4856,20,232,252,False
2011-07-22,8,4857,30,292,322,False
2011-07-22,9,4858,31,177,208,False
2011-07-22,10,4859,32,83,115,False
2011-07-22,11,4860,23,86,109,False
2011-07-22,12,4861,20,95,115,False
2011-07-22,13,4862,25,98,123,False
2011-07-22,14,4863,24,77,101,False
2011-07-22,15,4864,32,101,133,False
2011-07-22,16,4865,29,153,182,False
2011-07-22,17,4866,35,271,306,False
2011-07-22,18,4867,34,250,284,False
2011-07-22,19,4868,40,210,250,False
2011-07-22,20,4869,46,166,212,False
2011-07-22,21,4870,38,152,190,False
2011-07-22,22,4871,44,105,149,False
2011-07-22,23,4872,19,84,103,False
2011-07-23,0,4873,16,85,101,False
2011-07-23,1,4874,13,57,70,False
2011-07-23,2,4875,13,48,61,False
2011-07-23,3,4876,6,16,22,False
2011-07-23,4,4877,5,4,9,False
2011-07-23,5,4878,1,6,7,False
2011-07-23,6,4879,6,19,25,False
2011-07-23,7,4880,7,38,45,False
2011-07-23,8,4881,24,85,109,False
2011-07-23,9,4882,30,102,132,False
2011-07-23,10,4883,61,137,198,False
2011-07-23,11,4884,62,154,216,False
2011-07-23,12,4885,71,164,235,False
2011-07-23,13,4886,78,167,245,False
2011-07-23,14,4887,84,152,236,False
2011-07-23,15,4888,78,137,215,False
2011-07-23,16,4889,70,151,221,False
2011-07-23,17,4890,70,127,197,False
2011-07-23,18,4891,62,134,196,False
2011-07-23,19,4892,80,137,217,False
2011-07-23,20,4893,47,98,145,False
2011-07-23,21,4894,39,115,154,False
2011-07-23,22,4895,37,88,125,False
2011-07-23,23,4896,27,77,104,False
2011-07-24,0,4897,42,77,119,False
2011-07-24,1,4898,33,63,96,False
2011-07-24,2,4899,12,48,60,False
2011-07-24,3,4900,17,20,37,False
2011-07-24,4,4901,1,5,6,False
2011-07-24,5,4902,5,3,8,False
2011-07-24,6,4903,9,13,22,False
2011-07-24,7,4904,6,29,35,False
2011-07-24,8,4905,22,82,104,False
2011-07-24,9,4906,42,112,154,False
2011-07-24,10,4907,61,165,226,False
2011-07-24,11,4908,74,169,243,False
2011-07-24,12,4909,85,161,246,False
2011-07-24,13,4910,90,162,252,False
2011-07-24,14,4911,79,204,283,False
2011-07-24,15,4912,68,170,238,False
2011-07-24,16,4913,62,187,249,False
2011-07-24,17,4914,75,174,249,False
2011-07-24,18,4915,67,176,243,False
2011-07-24,19,4916,70,170,240,False
2011-07-24,20,4917,52,143,195,False
2011-07-24,21,4918,42,111,153,False
2011-07-24,22,4919,23,75,98,False
2011-07-24,23,4920,13,37,50,False
2011-07-25,0,4921,17,17,34,False
2011-07-25,1,4922,4,8,12,False
2011-07-25,2,4923,3,3,6,False
2011-07-25,3,4924,2,2,4,False
2011-07-25,4,4925,0,6,6,False
2011-07-25,5,4926,2,22,24,False
2011-07-25,6,4927,7,100,107,False
2011-07-25,7,4928,20,257,277,False
2011-07-25,8,4929,34,353,387,False
2011-07-25,9,4930,11,124,135,False
2011-07-25,10,4931,30,54,84,False
2011-07-25,11,4932,24,83,107,False
2011-07-25,12,4933,17,50,67,False
2011-07-25,13,4934,14,64,78,False
2011-07-25,14,4935,28,62,90,False
2011-07-25,15,4936,16,96,112,False
2011-07-25,16,4937,37,161,198,False
2011-07-25,17,4938,48,437,485,False
2011-07-25,18,4939,60,473,533,False
2011-07-25,19,4940,62,324,386,False
2011-07-25,20,4941,55,247,302,False
2011-07-25,21,4942,41,153,194,False
2011-07-25,22,4943,13,112,125,False
2011-07-25,23,4944,23,64,87,False
2011-07-26,0,4945,8,20,28,False
2011-07-26,1,4946,6,6,12,False
2011-07-26,2,4947,1,6,7,False
2011-07-26,3,4948,2,2,4,False
2011-07-26,4,4949,0,6,6,False
2011-07-26,5,4950,3,24,27,False
2011-07-26,6,4951,2,108,110,False
2011-07-26,7,4952,30,288,318,False
2011-07-26,8,4953,32,392,424,False
2011-07-26,9,4954,25,162,187,False
2011-07-26,10,4955,42,96,138,False
2011-07-26,11,4956,49,102,151,False
2011-07-26,12,4957,25,122,147,False
2011-07-26,13,4958,43,139,182,False
2011-07-26,14,4959,46,101,147,False
2011-07-26,15,4960,49,114,163,False
2011-07-26,16,4961,41,213,254,False
2011-07-26,17,4962,72,465,537,False
2011-07-26,18,4963,68,478,546,False
2011-07-26,19,4964,69,329,398,False
2011-07-26,20,4965,47,243,290,False
2011-07-26,21,4966,45,222,267,False
2011-07-26,22,4967,27,131,158,False
2011-07-26,23,4968,18,71,89,False
2011-07-27,0,4969,19,26,45,False
2011-07-27,1,4970,1,9,10,False
2011-07-27,2,4971,1,5,6,False
2011-07-27,3,4972,0,4,4,False
2011-07-27,4,4973,1,3,4,False
2011-07-27,5,4974,0,18,18,False
2011-07-27,6,4975,4,119,123,False
2011-07-27,7,4976,34,313,347,False
2011-07-27,8,4977,28,405,433,False
2011-07-27,9,4978,27,189,216,False
2011-07-27,10,4979,32,82,114,False
2011-07-27,11,4980,42,94,136,False
2011-07-27,12,4981,37,132,169,False
2011-07-27,13,4982,29,151,180,False
2011-07-27,14,4983,20,107,127,False
2011-07-27,15,4984,37,103,140,False
2011-07-27,16,4985,40,228,268,False
2011-07-27,17,4986,81,491,572,False
2011-07-27,18,4987,78,463,541,False
2011-07-27,19,4988,87,288,375,False
2011-07-27,20,4989,55,239,294,False
2011-07-27,21,4990,49,196,245,False
2011-07-27,22,4991,37,143,180,False
2011-07-27,23,4992,16,93,109,False
2011-07-28,0,4993,14,31,45,False
2011-07-28,1,4994,3,26,29,False
2011-07-28,2,4995,2,5,7,False
2011-07-28,3,4996,0,5,5,False
2011-07-28,4,4997,0,6,6,False
2011-07-28,5,4998,1,26,27,False
2011-07-28,6,4999,6,110,116,False
2011-07-28,7,5000,27,278,305,False
2011-07-28,8,5001,47,409,456,False
2011-07-28,9,5002,21,189,210,False
2011-07-28,10,5003,30,86,116,False
2011-07-28,11,5004,41,113,154,False
2011-07-28,12,5005,35,151,186,False
2011-07-28,13,5006,26,126,152,False
2011-07-28,14,5007,27,111,138,False
2011-07-28,15,5008,22,124,146,False
2011-07-28,16,5009,42,214,256,False
2011-07-28,17,5010,45,423,468,False
2011-07-28,18,5011,55,428,483,False
2011-07-28,19,5012,37,285,322,False
2011-07-28,20,5013,41,229,270,False
2011-07-28,21,5014,31,165,196,False
2011-07-28,22,5015,25,149,174,False
2011-07-28,23,5016,28,95,123,False
2011-07-29,0,5017,12,45,57,False
2011-07-29,1,5018,12,22,34,False
2011-07-29,2,5019,3,10,13,False
2011-07-29,3,5020,2,9,11,False
2011-07-29,4,5021,2,4,6,False
2011-07-29,5,5022,4,23,27,False
2011-07-29,6,5023,7,83,90,False
2011-07-29,7,5024,26,228,254,False
2011-07-29,8,5025,30,354,384,False
2011-07-29,9,5026,28,151,179,False
2011-07-29,10,5027,37,69,106,False
2011-07-29,11,5028,43,118,161,False
2011-07-29,12,5029,40,95,135,False
2011-07-29,13,5030,42,114,156,False
2011-07-29,14,5031,34,114,148,False
2011-07-29,15,5032,40,129,169,False
2011-07-29,16,5033,35,198,233,False
2011-07-29,17,5034,47,374,421,False
2011-07-29,18,5035,49,313,362,False
2011-07-29,19,5036,22,219,241,False
2011-07-29,20,5037,53,153,206,False
2011-07-29,21,5038,29,134,163,False
2011-07-29,22,5039,47,127,174,False
2011-07-29,23,5040,26,90,116,False
2011-07-30,0,5041,60,73,133,False
2011-07-30,1,5042,15,75,90,False
2011-07-30,2,5043,11,31,42,False
2011-07-30,3,5044,18,25,43,False
2011-07-30,4,5045,4,6,10,False
2011-07-30,5,5046,4,9,13,False
2011-07-30,6,5047,6,18,24,False
2011-07-30,7,5048,3,39,42,False
2011-07-30,8,5049,27,87,114,False
2011-07-30,9,5050,49,125,174,False
2011-07-30,10,5051,79,182,261,False
2011-07-30,11,5052,111,206,317,False
2011-07-30,12,5053,111,230,341,False
2011-07-30,13,5054,125,183,308,False
2011-07-30,14,5055,112,193,305,False
2011-07-30,15,5056,113,189,302,False
2011-07-30,16,5057,126,176,302,False
2011-07-30,17,5058,93,209,302,False
2011-07-30,18,5059,92,207,299,False
2011-07-30,19,5060,101,155,256,False
2011-07-30,20,5061,74,132,206,False
2011-07-30,21,5062,82,123,205,False
2011-07-30,22,5063,80,129,209,False
2011-07-30,23,5064,63,114,177,False
2011-07-31,0,5065,33,80,113,False
2011-07-31,1,5066,8,71,79,False
2011-07-31,2,5067,19,48,67,False
2011-07-31,3,5068,24,26,50,False
2011-07-31,4,5069,6,7,13,False
2011-07-31,5,5070,4,4,8,False
2011-07-31,6,5071,5,8,13,False
2011-07-31,7,5072,19,26,45,False
2011-07-31,8,5073,54,88,142,False
2011-07-31,9,5074,55,128,183,False
2011-07-31,10,5075,91,163,254,False
2011-07-31,11,5076,112,163,275,False
2011-07-31,12,5077,146,192,338,False
2011-07-31,13,5078,142,152,294,False
2011-07-31,14,5079,130,196,326,False
2011-07-31,15,5080,109,184,293,False
2011-07-31,16,5081,98,208,306,False
2011-07-31,17,5082,114,206,320,False
2011-07-31,18,5083,91,213,304,False
2011-07-31,19,5084,87,187,274,False
2011-07-31,20,5085,70,205,275,False
2011-07-31,21,5086,68,96,164,False
2011-07-31,22,5087,25,71,96,False
2011-07-31,23,5088,14,56,70,False
2011-08-01,0,5089,7,22,29,False
2011-08-01,1,5090,5,12,17,False
2011-08-01,2,5091,4,7,11,False
2011-08-01,3,5092,0,4,4,False
2011-08-01,4,5093,2,2,4,False
2011-08-01,5,5094,2,24,26,False
2011-08-01,6,5095,3,97,100,False
2011-08-01,7,5096,24,258,282,False
2011-08-01,8,5097,35,347,382,False
2011-08-01,9,5098,27,139,166,False
2011-08-01,10,5099,27,70,97,False
2011-08-01,11,5100,53,66,119,False
2011-08-01,12,5101,53,115,168,False
2011-08-01,13,5102,38,112,150,False
2011-08-01,14,5103,37,86,123,False
2011-08-01,15,5104,52,77,129,False
2011-08-01,16,5105,34,197,231,False
2011-08-01,17,5106,69,445,514,False
2011-08-01,18,5107,68,475,543,False
2011-08-01,19,5108,63,350,413,False
2011-08-01,20,5109,49,256,305,False
2011-08-01,21,5110,42,178,220,False
2011-08-01,22,5111,21,116,137,False
2011-08-01,23,5112,14,82,96,False
2011-08-02,0,5113,11,18,29,False
2011-08-02,1,5114,4,8,12,False
2011-08-02,2,5115,2,6,8,False
2011-08-02,3,5116,0,5,5,False
2011-08-02,4,5117,0,10,10,False
2011-08-02,5,5118,4,17,21,False
2011-08-02,6,5119,12,105,117,False
2011-08-02,7,5120,15,320,335,False
2011-08-02,8,5121,37,398,435,False
2011-08-02,9,5122,31,182,213,False
2011-08-02,10,5123,50,90,140,False
2011-08-02,11,5124,32,96,128,False
2011-08-02,12,5125,45,112,157,False
2011-08-02,13,5126,50,153,203,False
2011-08-02,14,5127,45,114,159,False
2011-08-02,15,5128,48,120,168,False
2011-08-02,16,5129,58,216,274,False
2011-08-02,17,5130,63,493,556,False
2011-08-02,18,5131,65,491,556,False
2011-08-02,19,5132,85,369,454,False
2011-08-02,20,5133,40,248,288,False
2011-08-02,21,5134,53,201,254,False
2011-08-02,22,5135,22,169,191,False
2011-08-02,23,5136,29,103,132,False
2011-08-03,0,5137,11,32,43,False
2011-08-03,1,5138,7,9,16,False
2011-08-03,2,5139,2,9,11,False
2011-08-03,3,5140,0,4,4,False
2011-08-03,4,5141,0,7,7,False
2011-08-03,5,5142,2,22,24,False
2011-08-03,6,5143,9,101,110,False
2011-08-03,7,5144,19,252,271,False
2011-08-03,8,5145,29,408,437,False
2011-08-03,9,5146,23,172,195,False
2011-08-03,10,5147,9,59,68,False
2011-08-03,11,5148,29,93,122,False
2011-08-03,12,5149,19,142,161,False
2011-08-03,13,5150,37,107,144,False
2011-08-03,14,5151,43,104,147,False
2011-08-03,15,5152,31,87,118,False
2011-08-03,16,5153,21,129,150,False
2011-08-03,17,5154,47,378,425,False
2011-08-03,18,5155,49,443,492,False
2011-08-03,19,5156,51,270,321,False
2011-08-03,20,5157,7,80,87,False
2011-08-03,21,5158,7,81,88,False
2011-08-03,22,5159,11,66,77,False
2011-08-03,23,5160,4,52,56,False
2011-08-04,0,5161,2,15,17,False
2011-08-04,1,5162,3,14,17,False
2011-08-04,2,5163,2,5,7,False
2011-08-04,3,5164,0,3,3,False
2011-08-04,4,5165,0,7,7,False
2011-08-04,5,5166,3,17,20,False
2011-08-04,6,5167,7,90,97,False
2011-08-04,7,5168,11,271,282,False
2011-08-04,8,5169,29,369,398,False
2011-08-04,9,5170,25,162,187,False
2011-08-04,10,5171,24,89,113,False
2011-08-04,11,5172,37,112,149,False
2011-08-04,12,5173,53,152,205,False
2011-08-04,13,5174,63,142,205,False
2011-08-04,14,5175,53,114,167,False
2011-08-04,15,5176,50,115,165,False
2011-08-04,16,5177,70,220,290,False
2011-08-04,17,5178,91,464,555,False
2011-08-04,18,5179,88,435,523,False
2011-08-04,19,5180,65,301,366,False
2011-08-04,20,5181,41,245,286,False
2011-08-04,21,5182,25,186,211,False
2011-08-04,22,5183,33,141,174,False
2011-08-04,23,5184,24,108,132,False
2011-08-05,0,5185,13,41,54,False
2011-08-05,1,5186,3,16,19,False
2011-08-05,2,5187,5,14,19,False
2011-08-05,3,5188,0,6,6,False
2011-08-05,4,5189,1,6,7,False
2011-08-05,5,5190,0,16,16,False
2011-08-05,6,5191,7,94,101,False
2011-08-05,7,5192,23,247,270,False
2011-08-05,8,5193,39,415,454,False
2011-08-05,9,5194,43,183,226,False
2011-08-05,10,5195,50,113,163,False
2011-08-05,11,5196,44,103,147,False
2011-08-05,12,5197,57,159,216,False
2011-08-05,13,5198,40,164,204,False
2011-08-05,14,5199,81,164,245,False
2011-08-05,15,5200,50,160,210,False
2011-08-05,16,5201,76,254,330,False
2011-08-05,17,5202,84,466,550,False
2011-08-05,18,5203,105,361,466,False
2011-08-05,19,5204,90,282,372,False
2011-08-05,20,5205,70,221,291,False
2011-08-05,21,5206,54,119,173,False
2011-08-05,22,5207,51,137,188,False
2011-08-05,23,5208,37,102,139,False
2011-08-06,0,5209,29,104,133,False
2011-08-06,1,5210,17,50,67,False
2011-08-06,2,5211,14,39,53,False
2011-08-06,3,5212,14,28,42,False
2011-08-06,4,5213,5,5,10,False
2011-08-06,5,5214,2,4,6,False
2011-08-06,6,5215,5,22,27,False
2011-08-06,7,5216,14,49,63,False
2011-08-06,8,5217,27,94,121,False
2011-08-06,9,5218,60,155,215,False
2011-08-06,10,5219,91,199,290,False
2011-08-06,11,5220,138,211,349,False
2011-08-06,12,5221,130,252,382,False
2011-08-06,13,5222,176,265,441,False
2011-08-06,14,5223,176,204,380,False
2011-08-06,15,5224,130,232,362,False
2011-08-06,16,5225,155,188,343,False
2011-08-06,17,5226,61,88,149,False
2011-08-06,18,5227,81,130,211,False
2011-08-06,19,5228,57,114,171,False
2011-08-06,20,5229,58,79,137,False
2011-08-06,21,5230,28,86,114,False
2011-08-06,22,5231,24,96,120,False
2011-08-06,23,5232,29,79,108,False
2011-08-07,0,5233,14,66,80,False
2011-08-07,1,5234,10,63,73,False
2011-08-07,2,5235,18,48,66,False
2011-08-07,3,5236,9,23,32,False
2011-08-07,4,5237,1,5,6,False
2011-08-07,5,5238,1,4,5,False
2011-08-07,6,5239,3,10,13,False
2011-08-07,7,5240,11,28,39,False
2011-08-07,8,5241,23,66,89,False
2011-08-07,9,5242,82,102,184,False
2011-08-07,10,5243,88,178,266,False
2011-08-07,11,5244,113,156,269,False
2011-08-07,12,5245,161,209,370,False
2011-08-07,13,5246,118,206,324,False
2011-08-07,14,5247,130,192,322,False
2011-08-07,15,5248,118,208,326,False
2011-08-07,16,5249,74,119,193,False
2011-08-07,17,5250,63,131,194,False
2011-08-07,18,5251,74,155,229,False
2011-08-07,19,5252,68,160,228,False
2011-08-07,20,5253,50,133,183,False
2011-08-07,21,5254,36,100,136,False
2011-08-07,22,5255,21,82,103,False
2011-08-07,23,5256,12,43,55,False
2011-08-08,0,5257,13,17,30,False
2011-08-08,1,5258,4,8,12,False
2011-08-08,2,5259,4,3,7,False
2011-08-08,3,5260,1,0,1,False
2011-08-08,4,5261,2,8,10,False
2011-08-08,5,5262,1,14,15,False
2011-08-08,6,5263,8,87,95,False
2011-08-08,7,5264,18,249,267,False
2011-08-08,8,5265,29,320,349,False
2011-08-08,9,5266,37,146,183,False
2011-08-08,10,5267,62,62,124,False
2011-08-08,11,5268,90,89,179,False
2011-08-08,12,5269,48,134,182,False
2011-08-08,13,5270,43,108,151,False
2011-08-08,14,5271,41,109,150,False
2011-08-08,15,5272,40,86,126,False
2011-08-08,16,5273,64,218,282,False
2011-08-08,17,5274,67,460,527,False
2011-08-08,18,5275,64,465,529,False
2011-08-08,19,5276,64,352,416,False
2011-08-08,20,5277,71,215,286,False
2011-08-08,21,5278,30,156,186,False
2011-08-08,22,5279,26,121,147,False
2011-08-08,23,5280,19,53,72,False
2011-08-09,0,5281,10,25,35,False
2011-08-09,1,5282,5,9,14,False
2011-08-09,2,5283,9,3,12,False
2011-08-09,3,5284,0,3,3,False
2011-08-09,4,5285,1,6,7,False
2011-08-09,5,5286,5,25,30,False
2011-08-09,6,5287,6,95,101,False
2011-08-09,7,5288,30,313,343,False
2011-08-09,8,5289,40,352,392,False
2011-08-09,9,5290,34,141,175,False
2011-08-09,10,5291,55,89,144,False
2011-08-09,11,5292,61,88,149,False
2011-08-09,12,5293,60,125,185,False
2011-08-09,13,5294,48,127,175,False
2011-08-09,14,5295,53,95,148,False
2011-08-09,15,5296,58,106,164,False
2011-08-09,16,5297,57,228,285,False
2011-08-09,17,5298,79,453,532,False
2011-08-09,18,5299,97,488,585,False
2011-08-09,19,5300,69,302,371,False
2011-08-09,20,5301,34,258,292,False
2011-08-09,21,5302,46,184,230,False
2011-08-09,22,5303,28,127,155,False
2011-08-09,23,5304,22,53,75,False
2011-08-10,0,5305,19,18,37,False
2011-08-10,1,5306,7,10,17,False
2011-08-10,2,5307,1,10,11,False
2011-08-10,3,5308,1,3,4,False
2011-08-10,4,5309,1,4,5,False
2011-08-10,5,5310,2,30,32,False
2011-08-10,6,5311,9,110,119,False
2011-08-10,7,5312,16,289,305,False
2011-08-10,8,5313,38,361,399,False
2011-08-10,9,5314,32,148,180,False
2011-08-10,10,5315,41,72,113,False
2011-08-10,11,5316,54,95,149,False
2011-08-10,12,5317,74,166,240,False
2011-08-10,13,5318,41,150,191,False
2011-08-10,14,5319,62,116,178,False
2011-08-10,15,5320,53,141,194,False
2011-08-10,16,5321,76,206,282,False
2011-08-10,17,5322,71,513,584,False
2011-08-10,18,5323,70,489,559,False
2011-08-10,19,5324,79,334,413,False
2011-08-10,20,5325,59,253,312,False
2011-08-10,21,5326,47,162,209,False
2011-08-10,22,5327,17,122,139,False
2011-08-10,23,5328,14,94,108,False
2011-08-11,0,5329,6,40,46,False
2011-08-11,1,5330,9,17,26,False
2011-08-11,2,5331,3,8,11,False
2011-08-11,3,5332,2,7,9,False
2011-08-11,4,5333,1,4,5,False
2011-08-11,5,5334,2,23,25,False
2011-08-11,6,5335,5,101,106,False
2011-08-11,7,5336,15,292,307,False
2011-08-11,8,5337,29,361,390,False
2011-08-11,9,5338,31,166,197,False
2011-08-11,10,5339,36,96,132,False
2011-08-11,11,5340,59,128,187,False
2011-08-11,12,5341,50,164,214,False
2011-08-11,13,5342,51,166,217,False
2011-08-11,14,5343,39,103,142,False
2011-08-11,15,5344,52,126,178,False
2011-08-11,16,5345,57,241,298,False
2011-08-11,17,5346,96,486,582,False
2011-08-11,18,5347,74,497,571,False
2011-08-11,19,5348,48,323,371,False
2011-08-11,20,5349,56,232,288,False
2011-08-11,21,5350,35,171,206,False
2011-08-11,22,5351,34,123,157,False
2011-08-11,23,5352,22,105,127,False
2011-08-12,0,5353,12,53,65,False
2011-08-12,1,5354,4,19,23,False
2011-08-12,2,5355,0,15,15,False
2011-08-12,3,5356,0,9,9,False
2011-08-12,4,5357,0,5,5,False
2011-08-12,5,5358,2,24,26,False
2011-08-12,6,5359,3,73,76,False
2011-08-12,7,5360,17,247,264,False
2011-08-12,8,5361,29,397,426,False
2011-08-12,9,5362,27,178,205,False
2011-08-12,10,5363,44,86,130,False
2011-08-12,11,5364,48,108,156,False
2011-08-12,12,5365,55,167,222,False
2011-08-12,13,5366,74,179,253,False
2011-08-12,14,5367,51,135,186,False
2011-08-12,15,5368,59,190,249,False
2011-08-12,16,5369,68,266,334,False
2011-08-12,17,5370,93,423,516,False
2011-08-12,18,5371,89,376,465,False
2011-08-12,19,5372,101,284,385,False
2011-08-12,20,5373,77,210,287,False
2011-08-12,21,5374,73,153,226,False
2011-08-12,22,5375,74,157,231,False
2011-08-12,23,5376,51,100,151,False
2011-08-13,0,5377,15,69,84,False
2011-08-13,1,5378,13,64,77,False
2011-08-13,2,5379,16,58,74,False
2011-08-13,3,5380,9,18,27,False
2011-08-13,4,5381,5,5,10,False
2011-08-13,5,5382,3,15,18,False
2011-08-13,6,5383,3,19,22,False
2011-08-13,7,5384,10,34,44,False
2011-08-13,8,5385,28,90,118,False
2011-08-13,9,5386,70,138,208,False
2011-08-13,10,5387,97,163,260,False
2011-08-13,11,5388,122,192,314,False
2011-08-13,12,5389,175,246,421,False
2011-08-13,13,5390,61,92,153,False
2011-08-13,14,5391,113,146,259,False
2011-08-13,15,5392,150,208,358,False
2011-08-13,16,5393,148,133,281,False
2011-08-13,17,5394,97,172,269,False
2011-08-13,18,5395,123,169,292,False
2011-08-13,19,5396,67,170,237,False
2011-08-13,20,5397,78,105,183,False
2011-08-13,21,5398,40,127,167,False
2011-08-13,22,5399,36,118,154,False
2011-08-13,23,5400,25,95,120,False
2011-08-14,0,5401,19,71,90,False
2011-08-14,1,5402,16,57,73,False
2011-08-14,2,5403,13,49,62,False
2011-08-14,3,5404,5,22,27,False
2011-08-14,4,5405,1,2,3,False
2011-08-14,5,5406,1,9,10,False
2011-08-14,6,5407,2,4,6,False
2011-08-14,7,5408,4,20,24,False
2011-08-14,8,5409,20,21,41,False
2011-08-14,9,5410,27,76,103,False
2011-08-14,10,5411,67,116,183,False
2011-08-14,11,5412,81,117,198,False
2011-08-14,12,5413,98,183,281,False
2011-08-14,13,5414,144,233,377,False
2011-08-14,14,5415,126,244,370,False
2011-08-14,15,5416,128,203,331,False
2011-08-14,16,5417,116,176,292,False
2011-08-14,17,5418,133,196,329,False
2011-08-14,18,5419,125,222,347,False
2011-08-14,19,5420,75,184,259,False
2011-08-14,20,5421,67,126,193,False
2011-08-14,21,5422,51,104,155,False
2011-08-14,22,5423,14,25,39,False
2011-08-14,23,5424,5,22,27,False
2011-08-15,0,5425,7,18,25,False
2011-08-15,1,5426,1,9,10,False
2011-08-15,2,5427,0,3,3,False
2011-08-15,3,5428,1,6,7,False
2011-08-15,4,5429,1,4,5,False
2011-08-15,5,5430,3,14,17,False
2011-08-15,6,5431,3,87,90,False
2011-08-15,7,5432,10,248,258,False
2011-08-15,8,5433,29,326,355,False
2011-08-15,9,5434,52,170,222,False
2011-08-15,10,5435,54,87,141,False
2011-08-15,11,5436,41,112,153,False
2011-08-15,12,5437,62,116,178,False
2011-08-15,13,5438,53,140,193,False
2011-08-15,14,5439,56,95,151,False
2011-08-15,15,5440,49,133,182,False
2011-08-15,16,5441,58,225,283,False
2011-08-15,17,5442,59,471,530,False
2011-08-15,18,5443,70,413,483,False
2011-08-15,19,5444,54,343,397,False
2011-08-15,20,5445,45,240,285,False
2011-08-15,21,5446,34,150,184,False
2011-08-15,22,5447,22,76,98,False
2011-08-15,23,5448,11,77,88,False
2011-08-16,0,5449,8,23,31,False
2011-08-16,1,5450,4,12,16,False
2011-08-16,2,5451,1,3,4,False
2011-08-16,3,5452,1,5,6,False
2011-08-16,4,5453,0,5,5,False
2011-08-16,5,5454,1,29,30,False
2011-08-16,6,5455,4,115,119,False
2011-08-16,7,5456,18,328,346,False
2011-08-16,8,5457,24,417,441,False
2011-08-16,9,5458,27,171,198,False
2011-08-16,10,5459,28,83,111,False
2011-08-16,11,5460,40,110,150,False
2011-08-16,12,5461,42,120,162,False
2011-08-16,13,5462,45,147,192,False
2011-08-16,14,5463,65,117,182,False
2011-08-16,15,5464,36,123,159,False
2011-08-16,16,5465,55,248,303,False
2011-08-16,17,5466,75,525,600,False
2011-08-16,18,5467,54,516,570,False
2011-08-16,19,5468,56,320,376,False
2011-08-16,20,5469,48,232,280,False
2011-08-16,21,5470,38,177,215,False
2011-08-16,22,5471,31,121,152,False
2011-08-16,23,5472,20,57,77,False
2011-08-17,0,5473,8,16,24,False
2011-08-17,1,5474,2,12,14,False
2011-08-17,2,5475,0,6,6,False
2011-08-17,3,5476,1,4,5,False
2011-08-17,4,5477,0,5,5,False
2011-08-17,5,5478,0,28,28,False
2011-08-17,6,5479,4,101,105,False
2011-08-17,7,5480,12,296,308,False
2011-08-17,8,5481,35,452,487,False
2011-08-17,9,5482,31,178,209,False
2011-08-17,10,5483,27,91,118,False
2011-08-17,11,5484,20,108,128,False
2011-08-17,12,5485,26,163,189,False
2011-08-17,13,5486,38,138,176,False
2011-08-17,14,5487,54,138,192,False
2011-08-17,15,5488,42,117,159,False
2011-08-17,16,5489,62,238,300,False
2011-08-17,17,5490,46,506,552,False
2011-08-17,18,5491,86,470,556,False
2011-08-17,19,5492,50,297,347,False
2011-08-17,20,5493,37,243,280,False
2011-08-17,21,5494,38,192,230,False
2011-08-17,22,5495,29,142,171,False
2011-08-17,23,5496,20,85,105,False
2011-08-18,0,5497,18,38,56,False
2011-08-18,1,5498,13,11,24,False
2011-08-18,2,5499,2,4,6,False
2011-08-18,3,5500,0,6,6,False
2011-08-18,4,5501,0,9,9,False
2011-08-18,5,5502,0,27,27,False
2011-08-18,6,5503,6,97,103,False
2011-08-18,7,5504,19,289,308,False
2011-08-18,8,5505,27,393,420,False
2011-08-18,9,5506,42,186,228,False
2011-08-18,10,5507,37,92,129,False
2011-08-18,11,5508,44,97,141,False
2011-08-18,12,5509,34,139,173,False
2011-08-18,13,5510,33,154,187,False
2011-08-18,14,5511,67,115,182,False
2011-08-18,15,5512,56,118,174,False
2011-08-18,16,5513,49,196,245,False
2011-08-18,17,5514,44,365,409,False
2011-08-18,18,5515,48,226,274,False
2011-08-18,19,5516,26,115,141,False
2011-08-18,20,5517,24,141,165,False
2011-08-18,21,5518,12,137,149,False
2011-08-18,22,5519,18,117,135,False
2011-08-18,23,5520,20,94,114,False
2011-08-19,0,5521,9,53,62,False
2011-08-19,1,5522,1,19,20,False
2011-08-19,2,5523,0,8,8,False
2011-08-19,3,5524,2,1,3,False
2011-08-19,4,5525,1,7,8,False
2011-08-19,5,5526,1,16,17,False
2011-08-19,6,5527,2,91,93,False
2011-08-19,7,5528,12,251,263,False
2011-08-19,8,5529,30,368,398,False
2011-08-19,9,5530,31,187,218,False
2011-08-19,10,5531,57,108,165,False
2011-08-19,11,5532,45,120,165,False
2011-08-19,12,5533,54,168,222,False
2011-08-19,13,5534,63,169,232,False
2011-08-19,14,5535,78,142,220,False
2011-08-19,15,5536,66,156,222,False
2011-08-19,16,5537,66,261,327,False
2011-08-19,17,5538,85,442,527,False
2011-08-19,18,5539,88,337,425,False
2011-08-19,19,5540,33,132,165,False
2011-08-19,20,5541,12,46,58,False
2011-08-19,21,5542,18,89,107,False
2011-08-19,22,5543,25,97,122,False
2011-08-19,23,5544,18,88,106,False
2011-08-20,0,5545,21,107,128,False
2011-08-20,1,5546,12,35,47,False
2011-08-20,2,5547,10,59,69,False
2011-08-20,3,5548,9,42,51,False
2011-08-20,4,5549,1,6,7,False
2011-08-20,5,5550,0,8,8,False
2011-08-20,6,5551,6,18,24,False
2011-08-20,7,5552,8,36,44,False
2011-08-20,8,5553,27,106,133,False
2011-08-20,9,5554,51,139,190,False
2011-08-20,10,5555,114,192,306,False
2011-08-20,11,5556,115,223,338,False
2011-08-20,12,5557,156,253,409,False
2011-08-20,13,5558,158,220,378,False
2011-08-20,14,5559,147,228,375,False
2011-08-20,15,5560,175,215,390,False
2011-08-20,16,5561,151,222,373,False
2011-08-20,17,5562,180,203,383,False
2011-08-20,18,5563,169,225,394,False
2011-08-20,19,5564,109,182,291,False
2011-08-20,20,5565,78,170,248,False
2011-08-20,21,5566,81,144,225,False
2011-08-20,22,5567,77,146,223,False
2011-08-20,23,5568,59,98,157,False
2011-08-21,0,5569,6,68,74,False
2011-08-21,1,5570,17,69,86,False
2011-08-21,2,5571,13,51,64,False
2011-08-21,3,5572,25,26,51,False
2011-08-21,4,5573,1,5,6,False
2011-08-21,5,5574,0,8,8,False
2011-08-21,6,5575,4,10,14,False
2011-08-21,7,5576,12,19,31,False
2011-08-21,8,5577,30,62,92,False
2011-08-21,9,5578,80,151,231,False
2011-08-21,10,5579,97,177,274,False
2011-08-21,11,5580,132,181,313,False
2011-08-21,12,5581,135,239,374,False
2011-08-21,13,5582,94,216,310,False
2011-08-21,14,5583,78,157,235,False
2011-08-21,15,5584,17,51,68,False
2011-08-21,16,5585,97,161,258,False
2011-08-21,17,5586,91,179,270,False
2011-08-21,18,5587,96,215,311,False
2011-08-21,19,5588,81,201,282,False
2011-08-21,20,5589,41,140,181,False
2011-08-21,21,5590,45,93,138,False
2011-08-21,22,5591,37,97,134,False
2011-08-21,23,5592,20,48,68,False
2011-08-22,0,5593,18,22,40,False
2011-08-22,1,5594,8,13,21,False
2011-08-22,2,5595,2,6,8,False
2011-08-22,3,5596,0,5,5,False
2011-08-22,4,5597,2,10,12,False
2011-08-22,5,5598,1,23,24,False
2011-08-22,6,5599,6,106,112,False
2011-08-22,7,5600,11,270,281,False
2011-08-22,8,5601,20,331,351,False
2011-08-22,9,5602,36,151,187,False
2011-08-22,10,5603,36,85,121,False
2011-08-22,11,5604,46,85,131,False
2011-08-22,12,5605,54,153,207,False
2011-08-22,13,5606,47,158,205,False
2011-08-22,14,5607,88,137,225,False
2011-08-22,15,5608,72,127,199,False
2011-08-22,16,5609,66,254,320,False
2011-08-22,17,5610,82,509,591,False
2011-08-22,18,5611,72,537,609,False
2011-08-22,19,5612,66,350,416,False
2011-08-22,20,5613,21,247,268,False
2011-08-22,21,5614,28,180,208,False
2011-08-22,22,5615,32,121,153,False
2011-08-22,23,5616,19,45,64,False
2011-08-23,0,5617,13,22,35,False
2011-08-23,1,5618,6,13,19,False
2011-08-23,2,5619,2,4,6,False
2011-08-23,3,5620,2,4,6,False
2011-08-23,4,5621,0,5,5,False
2011-08-23,5,5622,1,35,36,False
2011-08-23,6,5623,3,111,114,False
2011-08-23,7,5624,11,333,344,False
2011-08-23,8,5625,43,461,504,False
2011-08-23,9,5626,34,191,225,False
2011-08-23,10,5627,56,92,148,False
2011-08-23,11,5628,62,124,186,False
2011-08-23,12,5629,60,177,237,False
2011-08-23,13,5630,70,164,234,False
2011-08-23,14,5631,149,502,651,False
2011-08-23,15,5632,178,423,601,False
2011-08-23,16,5633,133,311,444,False
2011-08-23,17,5634,133,339,472,False
2011-08-23,18,5635,98,421,519,False
2011-08-23,19,5636,70,297,367,False
2011-08-23,20,5637,54,206,260,False
2011-08-23,21,5638,38,173,211,False
2011-08-23,22,5639,46,145,191,False
2011-08-23,23,5640,19,61,80,False
2011-08-24,0,5641,9,29,38,False
2011-08-24,1,5642,7,17,24,False
2011-08-24,2,5643,2,4,6,False
2011-08-24,3,5644,0,1,1,False
2011-08-24,4,5645,0,7,7,False
2011-08-24,5,5646,1,26,27,False
2011-08-24,6,5647,3,105,108,False
2011-08-24,7,5648,11,297,308,False
2011-08-24,8,5649,32,436,468,False
2011-08-24,9,5650,44,169,213,False
2011-08-24,10,5651,51,95,146,False
2011-08-24,11,5652,57,128,185,False
2011-08-24,12,5653,60,175,235,False
2011-08-24,13,5654,56,180,236,False
2011-08-24,14,5655,77,127,204,False
2011-08-24,15,5656,63,141,204,False
2011-08-24,16,5657,49,222,271,False
2011-08-24,17,5658,83,484,567,False
2011-08-24,18,5659,102,519,621,False
2011-08-24,19,5660,93,347,440,False
2011-08-24,20,5661,45,289,334,False
2011-08-24,21,5662,47,189,236,False
2011-08-24,22,5663,41,140,181,False
2011-08-24,23,5664,16,54,70,False
2011-08-25,0,5665,11,41,52,False
2011-08-25,1,5666,4,11,15,False
2011-08-25,2,5667,3,2,5,False
2011-08-25,3,5668,2,2,4,False
2011-08-25,4,5669,1,6,7,False
2011-08-25,5,5670,1,25,26,False
2011-08-25,6,5671,1,101,102,False
2011-08-25,7,5672,17,296,313,False
2011-08-25,8,5673,23,461,484,False
2011-08-25,9,5674,21,141,162,False
2011-08-25,10,5675,37,105,142,False
2011-08-25,11,5676,39,112,151,False
2011-08-25,12,5677,9,32,41,False
2011-08-25,13,5678,7,30,37,False
2011-08-25,14,5679,27,86,113,False
2011-08-25,15,5680,28,104,132,False
2011-08-25,16,5681,16,105,121,False
2011-08-25,17,5682,28,284,312,False
2011-08-25,18,5683,31,377,408,False
2011-08-25,19,5684,31,241,272,False
2011-08-25,20,5685,33,192,225,False
2011-08-25,21,5686,29,158,187,False
2011-08-25,22,5687,21,126,147,False
2011-08-25,23,5688,15,69,84,False
2011-08-26,0,5689,9,42,51,False
2011-08-26,1,5690,10,13,23,False
2011-08-26,2,5691,4,16,20,False
2011-08-26,3,5692,3,8,11,False
2011-08-26,4,5693,2,6,8,False
2011-08-26,5,5694,3,23,26,False
2011-08-26,6,5695,5,100,105,False
2011-08-26,7,5696,3,263,266,False
2011-08-26,8,5697,17,387,404,False
2011-08-26,9,5698,39,191,230,False
2011-08-26,10,5699,34,89,123,False
2011-08-26,11,5700,63,151,214,False
2011-08-26,12,5701,70,173,243,False
2011-08-26,13,5702,72,165,237,False
2011-08-26,14,5703,55,164,219,False
2011-08-26,15,5704,53,196,249,False
2011-08-26,16,5705,50,293,343,False
2011-08-26,17,5706,56,433,489,False
2011-08-26,18,5707,40,370,410,False
2011-08-26,19,5708,55,235,290,False
2011-08-26,20,5709,39,183,222,False
2011-08-26,21,5710,38,152,190,False
2011-08-26,22,5711,26,126,152,False
2011-08-26,23,5712,22,114,136,False
2011-08-27,0,5713,33,112,145,False
2011-08-27,1,5714,13,51,64,False
2011-08-27,2,5715,18,59,77,False
2011-08-27,3,5716,8,22,30,False
2011-08-27,4,5717,1,3,4,False
2011-08-27,5,5718,1,11,12,False
2011-08-27,6,5719,3,15,18,False
2011-08-27,7,5720,2,26,28,False
2011-08-27,8,5721,14,62,76,False
2011-08-27,9,5722,28,128,156,False
2011-08-27,10,5723,51,154,205,False
2011-08-27,11,5724,15,73,88,False
2011-08-27,12,5725,11,65,76,False
2011-08-27,13,5726,10,33,43,False
2011-08-27,14,5727,4,19,23,False
2011-08-27,15,5728,2,28,30,False
2011-08-27,16,5729,10,14,24,False
2011-08-27,17,5730,2,14,16,False
2011-08-27,18,5731,61,364,425,True
2011-08-27,19,5732,49,263,312,True
2011-08-27,20,5733,36,190,226,True
2011-08-27,21,5734,28,144,172,True
2011-08-27,22,5735,22,109,131,True
2011-08-27,23,5736,15,73,88,True
2011-08-28,0,5737,10,44,54,True
2011-08-28,1,5738,7,27,34,True
2011-08-28,2,5739,5,18,23,True
2011-08-28,3,5740,3,9,12,True
2011-08-28,4,5741,1,5,6,True
2011-08-28,5,5742,1,18,19,True
2011-08-28,6,5743,4,72,76,True
2011-08-28,7,5744,0,1,1,False
2011-08-28,8,5745,2,6,8,False
2011-08-28,9,5746,7,46,53,False
2011-08-28,10,5747,27,115,142,False
2011-08-28,11,5748,59,178,237,False
2011-08-28,12,5749,88,218,306,False
2011-08-28,13,5750,129,302,431,False
2011-08-28,14,5751,157,290,447,False
2011-08-28,15,5752,155,314,469,False
2011-08-28,16,5753,196,295,491,False
2011-08-28,17,5754,145,253,398,False
2011-08-28,18,5755,145,257,402,False
2011-08-28,19,5756,140,247,387,False
2011-08-28,20,5757,64,150,214,False
2011-08-28,21,5758,60,126,186,False
2011-08-28,22,5759,25,73,98,False
2011-08-28,23,5760,16,48,64,False
2011-08-29,0,5761,13,21,34,False
2011-08-29,1,5762,5,15,20,False
2011-08-29,2,5763,8,5,13,False
2011-08-29,3,5764,1,5,6,False
2011-08-29,4,5765,0,3,3,False
2011-08-29,5,5766,0,17,17,False
2011-08-29,6,5767,3,99,102,False
2011-08-29,7,5768,11,273,284,False
2011-08-29,8,5769,20,384,404,False
2011-08-29,9,5770,22,166,188,False
2011-08-29,10,5771,42,73,115,False
2011-08-29,11,5772,38,100,138,False
2011-08-29,12,5773,48,159,207,False
2011-08-29,13,5774,48,170,218,False
2011-08-29,14,5775,55,127,182,False
2011-08-29,15,5776,56,164,220,False
2011-08-29,16,5777,56,226,282,False
2011-08-29,17,5778,67,524,591,False
2011-08-29,18,5779,60,487,547,False
2011-08-29,19,5780,50,317,367,False
2011-08-29,20,5781,50,227,277,False
2011-08-29,21,5782,34,168,202,False
2011-08-29,22,5783,23,119,142,False
2011-08-29,23,5784,19,56,75,False
2011-08-30,0,5785,10,17,27,False
2011-08-30,1,5786,6,7,13,False
2011-08-30,2,5787,2,8,10,False
2011-08-30,3,5788,2,2,4,False
2011-08-30,4,5789,0,6,6,False
2011-08-30,5,5790,1,27,28,False
2011-08-30,6,5791,4,115,119,False
2011-08-30,7,5792,19,338,357,False
2011-08-30,8,5793,34,459,493,False
2011-08-30,9,5794,38,180,218,False
2011-08-30,10,5795,28,109,137,False
2011-08-30,11,5796,60,115,175,False
2011-08-30,12,5797,65,172,237,False
2011-08-30,13,5798,59,170,229,False
2011-08-30,14,5799,58,151,209,False
2011-08-30,15,5800,34,162,196,False
2011-08-30,16,5801,42,295,337,False
2011-08-30,17,5802,62,549,611,False
2011-08-30,18,5803,60,516,576,False
2011-08-30,19,5804,68,397,465,False
2011-08-30,20,5805,39,259,298,False
2011-08-30,21,5806,43,180,223,False
2011-08-30,22,5807,22,121,143,False
2011-08-30,23,5808,19,74,93,False
2011-08-31,0,5809,8,24,32,False
2011-08-31,1,5810,2,13,15,False
2011-08-31,2,5811,1,5,6,False
2011-08-31,3,5812,2,4,6,False
2011-08-31,4,5813,0,5,5,False
2011-08-31,5,5814,2,25,27,False
2011-08-31,6,5815,4,107,111,False
2011-08-31,7,5816,12,316,328,False
2011-08-31,8,5817,27,440,467,False
2011-08-31,9,5818,27,217,244,False
2011-08-31,10,5819,33,105,138,False
2011-08-31,11,5820,28,143,171,False
2011-08-31,12,5821,68,192,260,False
2011-08-31,13,5822,39,182,221,False
2011-08-31,14,5823,48,148,196,False
2011-08-31,15,5824,34,138,172,False
2011-08-31,16,5825,46,263,309,False
2011-08-31,17,5826,83,525,608,False
2011-08-31,18,5827,70,495,565,False
2011-08-31,19,5828,53,393,446,False
2011-08-31,20,5829,30,259,289,False
2011-08-31,21,5830,27,174,201,False
2011-08-31,22,5831,20,137,157,False
2011-08-31,23,5832,24,60,84,False
2011-09-01,0,5833,18,33,51,False
2011-09-01,1,5834,7,14,21,False
2011-09-01,2,5835,14,11,25,False
2011-09-01,3,5836,7,7,14,False
2011-09-01,4,5837,0,7,7,False
2011-09-01,5,5838,1,22,23,False
2011-09-01,6,5839,2,103,105,False
2011-09-01,7,5840,7,335,342,False
2011-09-01,8,5841,31,467,498,False
2011-09-01,9,5842,29,178,207,False
2011-09-01,10,5843,46,92,138,False
2011-09-01,11,5844,51,141,192,False
2011-09-01,12,5845,64,165,229,False
2011-09-01,13,5846,50,169,219,False
2011-09-01,14,5847,54,144,198,False
2011-09-01,15,5848,39,135,174,False
2011-09-01,16,5849,55,253,308,False
2011-09-01,17,5850,61,567,628,False
2011-09-01,18,5851,69,462,531,False
2011-09-01,19,5852,79,364,443,False
2011-09-01,20,5853,33,247,280,False
2011-09-01,21,5854,17,160,177,False
2011-09-01,22,5855,34,145,179,False
2011-09-01,23,5856,15,111,126,False
2011-09-02,0,5857,6,58,64,False
2011-09-02,1,5858,4,28,32,False
2011-09-02,2,5859,9,11,20,False
2011-09-02,3,5860,4,4,8,False
2011-09-02,4,5861,2,2,4,False
2011-09-02,5,5862,0,20,20,False
2011-09-02,6,5863,3,73,76,False
2011-09-02,7,5864,6,253,259,False
2011-09-02,8,5865,22,434,456,False
2011-09-02,9,5866,30,190,220,False
2011-09-02,10,5867,34,106,140,False
2011-09-02,11,5868,51,141,192,False
2011-09-02,12,5869,82,178,260,False
2011-09-02,13,5870,72,207,279,False
2011-09-02,14,5871,75,208,283,False
2011-09-02,15,5872,69,277,346,False
2011-09-02,16,5873,82,299,381,False
2011-09-02,17,5874,78,377,455,False
2011-09-02,18,5875,50,305,355,False
2011-09-02,19,5876,67,220,287,False
2011-09-02,20,5877,38,158,196,False
2011-09-02,21,5878,28,121,149,False
2011-09-02,22,5879,33,114,147,False
2011-09-02,23,5880,30,68,98,False
2011-09-03,0,5881,22,65,87,False
2011-09-03,1,5882,17,57,74,False
2011-09-03,2,5883,15,26,41,False
2011-09-03,3,5884,17,18,35,False
2011-09-03,4,5885,3,4,7,False
2011-09-03,5,5886,3,9,12,False
2011-09-03,6,5887,4,19,23,False
2011-09-03,7,5888,5,33,38,False
2011-09-03,8,5889,24,65,89,False
2011-09-03,9,5890,83,118,201,False
2011-09-03,10,5891,90,168,258,False
2011-09-03,11,5892,66,128,194,False
2011-09-03,12,5893,97,160,257,False
2011-09-03,13,5894,153,200,353,False
2011-09-03,14,5895,204,176,380,False
2011-09-03,15,5896,187,201,388,False
2011-09-03,16,5897,186,188,374,False
2011-09-03,17,5898,170,201,371,False
2011-09-03,18,5899,160,179,339,False
2011-09-03,19,5900,147,148,295,False
2011-09-03,20,5901,99,120,219,False
2011-09-03,21,5902,71,93,164,False
2011-09-03,22,5903,66,96,162,False
2011-09-03,23,5904,46,77,123,False
2011-09-04,0,5905,33,76,109,False
2011-09-04,1,5906,37,38,75,False
2011-09-04,2,5907,17,43,60,False
2011-09-04,3,5908,20,23,43,False
2011-09-04,4,5909,0,4,4,False
2011-09-04,5,5910,1,5,6,False
2011-09-04,6,5911,0,3,3,False
2011-09-04,7,5912,10,20,30,False
2011-09-04,8,5913,21,49,70,False
2011-09-04,9,5914,87,102,189,False
2011-09-04,10,5915,150,147,297,False
2011-09-04,11,5916,174,163,337,False
2011-09-04,12,5917,214,221,435,False
2011-09-04,13,5918,245,174,419,False
2011-09-04,14,5919,205,156,361,False
2011-09-04,15,5920,218,192,410,False
2011-09-04,16,5921,196,141,337,False
2011-09-04,17,5922,204,172,376,False
2011-09-04,18,5923,187,169,356,False
2011-09-04,19,5924,178,150,328,False
2011-09-04,20,5925,104,125,229,False
2011-09-04,21,5926,104,103,207,False
2011-09-04,22,5927,70,85,155,False
2011-09-04,23,5928,46,58,104,False
2011-09-05,0,5929,31,66,97,False
2011-09-05,1,5930,19,35,54,False
2011-09-05,2,5931,17,22,39,False
2011-09-05,3,5932,4,12,16,False
2011-09-05,4,5933,3,5,8,False
2011-09-05,5,5934,2,4,6,False
2011-09-05,6,5935,6,5,11,False
2011-09-05,7,5936,11,30,41,False
2011-09-05,8,5937,45,56,101,False
2011-09-05,9,5938,63,89,152,False
2011-09-05,10,5939,107,137,244,False
2011-09-05,11,5940,101,207,308,False
2011-09-05,12,5941,141,212,353,False
2011-09-05,13,5942,154,235,389,False
2011-09-05,14,5943,145,212,357,False
2011-09-05,15,5944,111,142,253,False
2011-09-05,16,5945,92,192,284,False
2011-09-05,17,5946,37,77,114,False
2011-09-05,18,5947,31,92,123,False
2011-09-05,19,5948,52,123,175,False
2011-09-05,20,5949,26,56,82,False
2011-09-05,21,5950,20,40,60,False
2011-09-05,22,5951,15,49,64,False
2011-09-05,23,5952,3,17,20,False
2011-09-06,0,5953,1,7,8,False
2011-09-06,1,5954,7,27,34,True
2011-09-06,2,5955,0,2,2,False
2011-09-06,3,5956,1,0,1,False
2011-09-06,4,5957,1,3,4,False
2011-09-06,5,5958,1,20,21,False
2011-09-06,6,5959,0,72,72,False
2011-09-06,7,5960,6,166,172,False
2011-09-06,8,5961,15,349,364,False
2011-09-06,9,5962,18,167,185,False
2011-09-06,10,5963,16,90,106,False
2011-09-06,11,5964,11,78,89,False
2011-09-06,12,5965,16,51,67,False
2011-09-06,13,5966,5,24,29,False
2011-09-06,14,5967,3,21,24,False
2011-09-06,15,5968,18,71,89,False
2011-09-06,16,5969,11,95,106,False
2011-09-06,17,5970,15,276,291,False
2011-09-06,18,5971,22,351,373,False
2011-09-06,19,5972,12,269,281,False
2011-09-06,20,5973,13,150,163,False
2011-09-06,21,5974,12,109,121,False
2011-09-06,22,5975,5,79,84,False
2011-09-06,23,5976,2,56,58,False
2011-09-07,0,5977,1,12,13,False
2011-09-07,1,5978,2,3,5,False
2011-09-07,2,5979,2,4,6,False
2011-09-07,3,5980,1,1,2,False
2011-09-07,4,5981,0,4,4,False
2011-09-07,5,5982,1,15,16,False
2011-09-07,6,5983,1,74,75,False
2011-09-07,7,5984,3,83,86,False
2011-09-07,8,5985,9,319,328,False
2011-09-07,9,5986,14,176,190,False
2011-09-07,10,5987,3,63,66,False
2011-09-07,11,5988,1,9,10,False
2011-09-07,12,5989,1,21,22,False
2011-09-07,13,5990,2,9,11,False
2011-09-07,14,5991,1,24,25,False
2011-09-07,15,5992,3,55,58,False
2011-09-07,16,5993,7,137,144,False
2011-09-07,17,5994,21,264,285,False
2011-09-07,18,5995,18,219,237,False
2011-09-07,19,5996,14,212,226,False
2011-09-07,20,5997,3,93,96,False
2011-09-07,21,5998,4,34,38,False
2011-09-07,22,5999,3,26,29,False
2011-09-07,23,6000,3,21,24,False
2011-09-08,0,6001,3,11,14,False
2011-09-08,1,6002,0,4,4,False
2011-09-08,2,6003,5,18,23,True
2011-09-08,3,6004,0,2,2,False
2011-09-08,4,6005,0,3,3,False
2011-09-08,5,6006,1,13,14,False
2011-09-08,6,6007,1,55,56,False
2011-09-08,7,6008,7,172,179,False
2011-09-08,8,6009,7,188,195,False
2011-09-08,9,6010,4,65,69,False
2011-09-08,10,6011,8,57,65,False
2011-09-08,11,6012,16,82,98,False
2011-09-08,12,6013,17,85,102,False
2011-09-08,13,6014,14,112,126,False
2011-09-08,14,6015,15,105,120,False
2011-09-08,15,6016,24,115,139,False
2011-09-08,16,6017,5,151,156,False
2011-09-08,17,6018,11,102,113,False
2011-09-08,18,6019,2,66,68,False
2011-09-08,19,6020,1,51,52,False
2011-09-08,20,6021,6,83,89,False
2011-09-08,21,6022,6,76,82,False
2011-09-08,22,6023,5,65,70,False
2011-09-08,23,6024,0,26,26,False
2011-09-09,0,6025,1,15,16,False
2011-09-09,1,6026,0,8,8,False
2011-09-09,2,6027,1,7,8,False
2011-09-09,3,6028,1,1,2,False
2011-09-09,4,6029,0,3,3,False
2011-09-09,5,6030,0,14,14,False
2011-09-09,6,6031,3,54,57,False
2011-09-09,7,6032,4,104,108,False
2011-09-09,8,6033,12,276,288,False
2011-09-09,9,6034,5,131,136,False
2011-09-09,10,6035,2,27,29,False
2011-09-09,11,6036,6,66,72,False
2011-09-09,12,6037,4,71,75,False
2011-09-09,13,6038,14,108,122,False
2011-09-09,14,6039,29,119,148,False
2011-09-09,15,6040,27,161,188,False
2011-09-09,16,6041,41,244,285,False
2011-09-09,17,6042,54,451,505,False
2011-09-09,18,6043,33,377,410,False
2011-09-09,19,6044,33,316,349,False
2011-09-09,20,6045,30,180,210,False
2011-09-09,21,6046,49,154,203,False
2011-09-09,22,6047,33,127,160,False
2011-09-09,23,6048,35,113,148,False
2011-09-10,0,6049,32,84,116,False
2011-09-10,1,6050,16,67,83,False
2011-09-10,2,6051,18,46,64,False
2011-09-10,3,6052,8,29,37,False
2011-09-10,4,6053,3,4,7,False
2011-09-10,5,6054,2,6,8,False
2011-09-10,6,6055,0,6,6,False
2011-09-10,7,6056,9,43,52,False
2011-09-10,8,6057,16,103,119,False
2011-09-10,9,6058,39,168,207,False
2011-09-10,10,6059,85,233,318,False
2011-09-10,11,6060,108,252,360,False
2011-09-10,12,6061,144,260,404,False
2011-09-10,13,6062,131,239,370,False
2011-09-10,14,6063,129,230,359,False
2011-09-10,15,6064,217,263,480,False
2011-09-10,16,6065,170,261,431,False
2011-09-10,17,6066,185,275,460,False
2011-09-10,18,6067,119,241,360,False
2011-09-10,19,6068,101,214,315,False
2011-09-10,20,6069,78,167,245,False
2011-09-10,21,6070,59,171,230,False
2011-09-10,22,6071,49,126,175,False
2011-09-10,23,6072,32,107,139,False
2011-09-11,0,6073,29,79,108,False
2011-09-11,1,6074,22,66,88,False
2011-09-11,2,6075,16,60,76,False
2011-09-11,3,6076,15,30,45,False
2011-09-11,4,6077,3,6,9,False
2011-09-11,5,6078,15,24,39,False
2011-09-11,6,6079,4,16,20,False
2011-09-11,7,6080,9,28,37,False
2011-09-11,8,6081,25,69,94,False
2011-09-11,9,6082,59,168,227,False
2011-09-11,10,6083,120,214,334,False
2011-09-11,11,6084,144,258,402,False
2011-09-11,12,6085,113,298,411,False
2011-09-11,13,6086,119,231,350,False
2011-09-11,14,6087,120,222,342,False
2011-09-11,15,6088,134,270,404,False
2011-09-11,16,6089,180,303,483,False
2011-09-11,17,6090,152,228,380,False
2011-09-11,18,6091,110,229,339,False
2011-09-11,19,6092,101,232,333,False
2011-09-11,20,6093,65,161,226,False
2011-09-11,21,6094,45,114,159,False
2011-09-11,22,6095,21,74,95,False
2011-09-11,23,6096,12,33,45,False
2011-09-12,0,6097,5,11,16,False
2011-09-12,1,6098,1,11,12,False
2011-09-12,2,6099,2,0,2,False
2011-09-12,3,6100,3,9,12,True
2011-09-12,4,6101,0,4,4,False
2011-09-12,5,6102,1,23,24,False
2011-09-12,6,6103,1,108,109,False
2011-09-12,7,6104,12,300,312,False
2011-09-12,8,6105,26,382,408,False
2011-09-12,9,6106,21,155,176,False
2011-09-12,10,6107,40,89,129,False
2011-09-12,11,6108,34,131,165,False
2011-09-12,12,6109,37,147,184,False
2011-09-12,13,6110,43,120,163,False
2011-09-12,14,6111,60,129,189,False
2011-09-12,15,6112,60,152,212,False
2011-09-12,16,6113,60,238,298,False
2011-09-12,17,6114,75,515,590,False
2011-09-12,18,6115,56,515,571,False
2011-09-12,19,6116,63,373,436,False
2011-09-12,20,6117,41,258,299,False
2011-09-12,21,6118,29,166,195,False
2011-09-12,22,6119,16,134,150,False
2011-09-12,23,6120,7,62,69,False
2011-09-13,0,6121,7,19,26,False
2011-09-13,1,6122,4,6,10,False
2011-09-13,2,6123,2,0,2,False
2011-09-13,3,6124,2,2,4,False
2011-09-13,4,6125,2,6,8,False
2011-09-13,5,6126,1,19,20,False
2011-09-13,6,6127,6,116,122,False
2011-09-13,7,6128,14,348,362,False
2011-09-13,8,6129,26,399,425,False
2011-09-13,9,6130,35,179,214,False
2011-09-13,10,6131,42,93,135,False
2011-09-13,11,6132,33,120,153,False
2011-09-13,12,6133,43,144,187,False
2011-09-13,13,6134,48,136,184,False
2011-09-13,14,6135,51,139,190,False
2011-09-13,15,6136,35,145,180,False
2011-09-13,16,6137,41,251,292,False
2011-09-13,17,6138,72,507,579,False
2011-09-13,18,6139,67,472,539,False
2011-09-13,19,6140,55,341,396,False
2011-09-13,20,6141,31,241,272,False
2011-09-13,21,6142,45,200,245,False
2011-09-13,22,6143,24,120,144,False
2011-09-13,23,6144,15,59,74,False
2011-09-14,0,6145,5,28,33,False
2011-09-14,1,6146,1,7,8,False
2011-09-14,2,6147,1,4,5,False
2011-09-14,3,6148,1,7,8,False
2011-09-14,4,6149,1,8,9,False
2011-09-14,5,6150,1,30,31,False
2011-09-14,6,6151,7,138,145,False
2011-09-14,7,6152,20,350,370,False
2011-09-14,8,6153,33,396,429,False
2011-09-14,9,6154,19,183,202,False
2011-09-14,10,6155,27,115,142,False
2011-09-14,11,6156,43,121,164,False
2011-09-14,12,6157,56,156,212,False
2011-09-14,13,6158,39,139,178,False
2011-09-14,14,6159,19,105,124,False
2011-09-14,15,6160,30,146,176,False
2011-09-14,16,6161,36,241,277,False
2011-09-14,17,6162,87,512,599,False
2011-09-14,18,6163,83,503,586,False
2011-09-14,19,6164,44,337,381,False
2011-09-14,20,6165,40,221,261,False
2011-09-14,21,6166,24,189,213,False
2011-09-14,22,6167,20,140,160,False
2011-09-14,23,6168,10,62,72,False
2011-09-15,0,6169,3,34,37,False
2011-09-15,1,6170,0,20,20,False
2011-09-15,2,6171,0,5,5,False
2011-09-15,3,6172,3,5,8,False
2011-09-15,4,6173,2,5,7,False
2011-09-15,5,6174,1,30,31,False
2011-09-15,6,6175,5,119,124,False
2011-09-15,7,6176,17,321,338,False
2011-09-15,8,6177,27,364,391,False
2011-09-15,9,6178,23,186,209,False
2011-09-15,10,6179,25,96,121,False
2011-09-15,11,6180,39,120,159,False
2011-09-15,12,6181,31,148,179,False
2011-09-15,13,6182,38,151,189,False
2011-09-15,14,6183,36,134,170,False
2011-09-15,15,6184,25,110,135,False
2011-09-15,16,6185,29,193,222,False
2011-09-15,17,6186,31,230,261,False
2011-09-15,18,6187,22,222,244,False
2011-09-15,19,6188,20,212,232,False
2011-09-15,20,6189,25,223,248,False
2011-09-15,21,6190,11,134,145,False
2011-09-15,22,6191,7,108,115,False
2011-09-15,23,6192,8,61,69,False
2011-09-16,0,6193,5,43,48,False
2011-09-16,1,6194,7,19,26,False
2011-09-16,2,6195,3,7,10,False
2011-09-16,3,6196,2,4,6,False
2011-09-16,4,6197,1,3,4,False
2011-09-16,5,6198,2,30,32,False
2011-09-16,6,6199,6,87,93,False
2011-09-16,7,6200,16,283,299,False
2011-09-16,8,6201,23,386,409,False
2011-09-16,9,6202,21,189,210,False
2011-09-16,10,6203,36,104,140,False
2011-09-16,11,6204,40,139,179,False
2011-09-16,12,6205,39,212,251,False
2011-09-16,13,6206,55,168,223,False
2011-09-16,14,6207,49,176,225,False
2011-09-16,15,6208,38,165,203,False
2011-09-16,16,6209,67,291,358,False
2011-09-16,17,6210,86,480,566,False
2011-09-16,18,6211,55,427,482,False
2011-09-16,19,6212,59,256,315,False
2011-09-16,20,6213,41,184,225,False
2011-09-16,21,6214,39,124,163,False
2011-09-16,22,6215,32,135,167,False
2011-09-16,23,6216,20,106,126,False
2011-09-17,0,6217,28,80,108,False
2011-09-17,1,6218,28,52,80,False
2011-09-17,2,6219,18,61,79,False
2011-09-17,3,6220,7,21,28,False
2011-09-17,4,6221,1,4,5,False
2011-09-17,5,6222,2,3,5,False
2011-09-17,6,6223,5,17,22,False
2011-09-17,7,6224,4,33,37,False
2011-09-17,8,6225,27,81,108,False
2011-09-17,9,6226,32,145,177,False
2011-09-17,10,6227,72,177,249,False
2011-09-17,11,6228,119,248,367,False
2011-09-17,12,6229,115,257,372,False
2011-09-17,13,6230,124,225,349,False
2011-09-17,14,6231,123,174,297,False
2011-09-17,15,6232,148,206,354,False
2011-09-17,16,6233,116,189,305,False
2011-09-17,17,6234,141,218,359,False
2011-09-17,18,6235,95,234,329,False
2011-09-17,19,6236,70,186,256,False
2011-09-17,20,6237,43,133,176,False
2011-09-17,21,6238,49,121,170,False
2011-09-17,22,6239,31,112,143,False
2011-09-17,23,6240,36,100,136,False
2011-09-18,0,6241,24,88,112,False
2011-09-18,1,6242,13,66,79,False
2011-09-18,2,6243,21,68,89,False
2011-09-18,3,6244,11,25,36,False
2011-09-18,4,6245,1,0,1,False
2011-09-18,5,6246,1,5,6,False
2011-09-18,6,6247,2,10,12,False
2011-09-18,7,6248,15,29,44,False
2011-09-18,8,6249,16,53,69,False
2011-09-18,9,6250,46,94,140,False
2011-09-18,10,6251,82,178,260,False
2011-09-18,11,6252,116,201,317,False
2011-09-18,12,6253,135,229,364,False
2011-09-18,13,6254,162,214,376,False
2011-09-18,14,6255,127,184,311,False
2011-09-18,15,6256,132,233,365,False
2011-09-18,16,6257,134,235,369,False
2011-09-18,17,6258,95,230,325,False
2011-09-18,18,6259,66,223,289,False
2011-09-18,19,6260,54,191,245,False
2011-09-18,20,6261,44,136,180,False
2011-09-18,21,6262,37,110,147,False
2011-09-18,22,6263,9,75,84,False
2011-09-18,23,6264,10,44,54,False
2011-09-19,0,6265,14,23,37,False
2011-09-19,1,6266,3,7,10,False
2011-09-19,2,6267,6,7,13,False
2011-09-19,3,6268,1,4,5,False
2011-09-19,4,6269,2,6,8,False
2011-09-19,5,6270,2,26,28,False
2011-09-19,6,6271,6,107,113,False
2011-09-19,7,6272,20,312,332,False
2011-09-19,8,6273,29,391,420,False
2011-09-19,9,6274,32,183,215,False
2011-09-19,10,6275,21,84,105,False
2011-09-19,11,6276,41,98,139,False
2011-09-19,12,6277,51,138,189,False
2011-09-19,13,6278,53,124,177,False
2011-09-19,14,6279,45,143,188,False
2011-09-19,15,6280,44,143,187,False
2011-09-19,16,6281,55,208,263,False
2011-09-19,17,6282,85,483,568,False
2011-09-19,18,6283,56,484,540,False
2011-09-19,19,6284,41,333,374,False
2011-09-19,20,6285,27,204,231,False
2011-09-19,21,6286,19,181,200,False
2011-09-19,22,6287,25,104,129,False
2011-09-19,23,6288,13,55,68,False
2011-09-20,0,6289,4,21,25,False
2011-09-20,1,6290,3,11,14,False
2011-09-20,2,6291,1,4,5,False
2011-09-20,3,6292,0,3,3,False
2011-09-20,4,6293,2,4,6,False
2011-09-20,5,6294,1,21,22,False
2011-09-20,6,6295,3,111,114,False
2011-09-20,7,6296,23,306,329,False
2011-09-20,8,6297,13,196,209,False
2011-09-20,9,6298,5,64,69,False
2011-09-20,10,6299,4,26,30,False
2011-09-20,11,6300,8,48,56,False
2011-09-20,12,6301,13,47,60,False
2011-09-20,13,6302,22,81,103,False
2011-09-20,14,6303,27,85,112,False
2011-09-20,15,6304,34,158,192,False
2011-09-20,16,6305,23,241,264,False
2011-09-20,17,6306,66,445,511,False
2011-09-20,18,6307,39,453,492,False
2011-09-20,19,6308,43,294,337,False
2011-09-20,20,6309,41,212,253,False
2011-09-20,21,6310,29,177,206,False
2011-09-20,22,6311,23,125,148,False
2011-09-20,23,6312,11,70,81,False
2011-09-21,0,6313,7,20,27,False
2011-09-21,1,6314,0,17,17,False
2011-09-21,2,6315,1,5,6,False
2011-09-21,3,6316,0,6,6,False
2011-09-21,4,6317,2,5,7,False
2011-09-21,5,6318,1,30,31,False
2011-09-21,6,6319,5,112,117,False
2011-09-21,7,6320,18,312,330,False
2011-09-21,8,6321,18,444,462,False
2011-09-21,9,6322,21,187,208,False
2011-09-21,10,6323,30,103,133,False
2011-09-21,11,6324,42,138,180,False
2011-09-21,12,6325,42,151,193,False
2011-09-21,13,6326,37,144,181,False
2011-09-21,14,6327,40,139,179,False
2011-09-21,15,6328,43,142,185,False
2011-09-21,16,6329,51,230,281,False
2011-09-21,17,6330,61,475,536,False
2011-09-21,18,6331,24,384,408,False
2011-09-21,19,6332,30,253,283,False
2011-09-21,20,6333,11,149,160,False
2011-09-21,21,6334,25,175,200,False
2011-09-21,22,6335,15,112,127,False
2011-09-21,23,6336,15,80,95,False
2011-09-22,0,6337,11,30,41,False
2011-09-22,1,6338,5,6,11,False
2011-09-22,2,6339,2,8,10,False
2011-09-22,3,6340,5,7,12,False
2011-09-22,4,6341,0,2,2,False
2011-09-22,5,6342,2,28,30,False
2011-09-22,6,6343,7,94,101,False
2011-09-22,7,6344,16,295,311,False
2011-09-22,8,6345,26,389,415,False
2011-09-22,9,6346,35,168,203,False
2011-09-22,10,6347,19,101,120,False
2011-09-22,11,6348,23,142,165,False
2011-09-22,12,6349,25,151,176,False
2011-09-22,13,6350,38,155,193,False
2011-09-22,14,6351,41,142,183,False
2011-09-22,15,6352,32,149,181,False
2011-09-22,16,6353,39,262,301,False
2011-09-22,17,6354,50,513,563,False
2011-09-22,18,6355,50,501,551,False
2011-09-22,19,6356,32,388,420,False
2011-09-22,20,6357,35,250,285,False
2011-09-22,21,6358,27,194,221,False
2011-09-22,22,6359,21,166,187,False
2011-09-22,23,6360,14,99,113,False
2011-09-23,0,6361,11,41,52,False
2011-09-23,1,6362,2,29,31,False
2011-09-23,2,6363,6,14,20,False
2011-09-23,3,6364,3,5,8,False
2011-09-23,4,6365,6,7,13,False
2011-09-23,5,6366,2,20,22,False
2011-09-23,6,6367,5,99,104,False
2011-09-23,7,6368,14,240,254,False
2011-09-23,8,6369,20,297,317,False
2011-09-23,9,6370,3,108,111,False
2011-09-23,10,6371,7,28,35,False
2011-09-23,11,6372,1,20,21,False
2011-09-23,12,6373,1,28,29,False
2011-09-23,13,6374,7,27,34,False
2011-09-23,14,6375,3,21,24,False
2011-09-23,15,6376,9,52,61,False
2011-09-23,16,6377,5,51,56,False
2011-09-23,17,6378,13,86,99,False
2011-09-23,18,6379,14,220,234,False
2011-09-23,19,6380,16,232,248,False
2011-09-23,20,6381,21,158,179,False
2011-09-23,21,6382,17,121,138,False
2011-09-23,22,6383,31,126,157,False
2011-09-23,23,6384,41,107,148,False
2011-09-24,0,6385,7,86,93,False
2011-09-24,1,6386,18,61,79,False
2011-09-24,2,6387,14,54,68,False
2011-09-24,3,6388,4,27,31,False
2011-09-24,4,6389,1,7,8,False
2011-09-24,5,6390,2,3,5,False
2011-09-24,6,6391,6,12,18,False
2011-09-24,7,6392,12,34,46,False
2011-09-24,8,6393,19,102,121,False
2011-09-24,9,6394,41,134,175,False
2011-09-24,10,6395,90,203,293,False
2011-09-24,11,6396,118,268,386,False
2011-09-24,12,6397,141,266,407,False
2011-09-24,13,6398,170,290,460,False
2011-09-24,14,6399,164,226,390,False
2011-09-24,15,6400,168,284,452,False
2011-09-24,16,6401,167,282,449,False
2011-09-24,17,6402,180,246,426,False
2011-09-24,18,6403,157,243,400,False
2011-09-24,19,6404,77,231,308,False
2011-09-24,20,6405,77,166,243,False
2011-09-24,21,6406,66,156,222,False
2011-09-24,22,6407,50,143,193,False
2011-09-24,23,6408,27,123,150,False
2011-09-25,0,6409,37,136,173,False
2011-09-25,1,6410,31,93,124,False
2011-09-25,2,6411,27,79,106,False
2011-09-25,3,6412,20,39,59,False
2011-09-25,4,6413,3,5,8,False
2011-09-25,5,6414,1,2,3,False
2011-09-25,6,6415,4,13,17,False
2011-09-25,7,6416,15,23,38,False
2011-09-25,8,6417,27,59,86,False
2011-09-25,9,6418,55,100,155,False
2011-09-25,10,6419,85,190,275,False
2011-09-25,11,6420,131,230,361,False
2011-09-25,12,6421,143,270,413,False
2011-09-25,13,6422,122,247,369,False
2011-09-25,14,6423,116,231,347,False
2011-09-25,15,6424,119,234,353,False
2011-09-25,16,6425,144,320,464,False
2011-09-25,17,6426,145,275,420,False
2011-09-25,18,6427,125,279,404,False
2011-09-25,19,6428,87,242,329,False
2011-09-25,20,6429,51,135,186,False
2011-09-25,21,6430,24,113,137,False
2011-09-25,22,6431,20,84,104,False
2011-09-25,23,6432,12,67,79,False
2011-09-26,0,6433,6,23,29,False
2011-09-26,1,6434,3,14,17,False
2011-09-26,2,6435,4,4,8,False
2011-09-26,3,6436,0,5,5,False
2011-09-26,4,6437,2,4,6,False
2011-09-26,5,6438,0,25,25,False
2011-09-26,6,6439,6,107,113,False
2011-09-26,7,6440,17,315,332,False
2011-09-26,8,6441,29,326,355,False
2011-09-26,9,6442,44,161,205,False
2011-09-26,10,6443,37,117,154,False
2011-09-26,11,6444,43,116,159,False
2011-09-26,12,6445,48,161,209,False
2011-09-26,13,6446,48,139,187,False
2011-09-26,14,6447,44,110,154,False
2011-09-26,15,6448,52,157,209,False
2011-09-26,16,6449,74,239,313,False
2011-09-26,17,6450,61,509,570,False
2011-09-26,18,6451,63,490,553,False
2011-09-26,19,6452,36,347,383,False
2011-09-26,20,6453,24,227,251,False
2011-09-26,21,6454,18,164,182,False
2011-09-26,22,6455,14,122,136,False
2011-09-26,23,6456,11,64,75,False
2011-09-27,0,6457,9,28,37,False
2011-09-27,1,6458,4,6,10,False
2011-09-27,2,6459,7,4,11,False
2011-09-27,3,6460,5,5,10,False
2011-09-27,4,6461,5,3,8,False
2011-09-27,5,6462,0,24,24,False
2011-09-27,6,6463,8,116,124,False
2011-09-27,7,6464,15,234,249,False
2011-09-27,8,6465,27,400,427,False
2011-09-27,9,6466,20,173,193,False
2011-09-27,10,6467,21,101,122,False
2011-09-27,11,6468,26,97,123,False
2011-09-27,12,6469,33,129,162,False
2011-09-27,13,6470,29,122,151,False
2011-09-27,14,6471,29,123,152,False
2011-09-27,15,6472,35,170,205,False
2011-09-27,16,6473,33,225,258,False
2011-09-27,17,6474,50,480,530,False
2011-09-27,18,6475,31,325,356,False
2011-09-27,19,6476,26,294,320,False
2011-09-27,20,6477,17,221,238,False
2011-09-27,21,6478,17,179,196,False
2011-09-27,22,6479,19,102,121,False
2011-09-27,23,6480,11,82,93,False
2011-09-28,0,6481,7,29,36,False
2011-09-28,1,6482,1,13,14,False
2011-09-28,2,6483,0,9,9,False
2011-09-28,3,6484,0,3,3,False
2011-09-28,4,6485,1,3,4,False
2011-09-28,5,6486,2,20,22,False
2011-09-28,6,6487,3,111,114,False
2011-09-28,7,6488,8,177,185,False
2011-09-28,8,6489,17,270,287,False
2011-09-28,9,6490,14,141,155,False
2011-09-28,10,6491,20,109,129,False
2011-09-28,11,6492,24,127,151,False
2011-09-28,12,6493,25,159,184,False
2011-09-28,13,6494,24,138,162,False
2011-09-28,14,6495,25,145,170,False
2011-09-28,15,6496,35,146,181,False
2011-09-28,16,6497,39,241,280,False
2011-09-28,17,6498,64,527,591,False
2011-09-28,18,6499,65,459,524,False
2011-09-28,19,6500,57,315,372,False
2011-09-28,20,6501,11,91,102,False
2011-09-28,21,6502,7,67,74,False
2011-09-28,22,6503,19,68,87,False
2011-09-28,23,6504,12,59,71,False
2011-09-29,0,6505,7,33,40,False
2011-09-29,1,6506,3,20,23,False
2011-09-29,2,6507,0,2,2,False
2011-09-29,3,6508,0,8,8,False
2011-09-29,4,6509,2,5,7,False
2011-09-29,5,6510,0,22,22,False
2011-09-29,6,6511,5,106,111,False
2011-09-29,7,6512,14,269,283,False
2011-09-29,8,6513,29,402,431,False
2011-09-29,9,6514,27,198,225,False
2011-09-29,10,6515,24,103,127,False
2011-09-29,11,6516,36,122,158,False
2011-09-29,12,6517,38,157,195,False
2011-09-29,13,6518,36,175,211,False
2011-09-29,14,6519,33,134,167,False
2011-09-29,15,6520,42,185,227,False
2011-09-29,16,6521,64,227,291,False
2011-09-29,17,6522,62,527,589,False
2011-09-29,18,6523,84,500,584,False
2011-09-29,19,6524,36,348,384,False
2011-09-29,20,6525,39,234,273,False
2011-09-29,21,6526,30,195,225,False
2011-09-29,22,6527,25,150,175,False
2011-09-29,23,6528,17,64,81,False
2011-09-30,0,6529,7,53,60,False
2011-09-30,1,6530,5,18,23,False
2011-09-30,2,6531,6,9,15,False
2011-09-30,3,6532,0,3,3,False
2011-09-30,4,6533,2,6,8,False
2011-09-30,5,6534,3,23,26,False
2011-09-30,6,6535,0,98,98,False
2011-09-30,7,6536,14,283,297,False
2011-09-30,8,6537,31,425,456,False
2011-09-30,9,6538,23,214,237,False
2011-09-30,10,6539,46,122,168,False
2011-09-30,11,6540,49,168,217,False
2011-09-30,12,6541,59,195,254,False
2011-09-30,13,6542,72,194,266,False
2011-09-30,14,6543,93,173,266,False
2011-09-30,15,6544,52,193,245,False
2011-09-30,16,6545,62,298,360,False
2011-09-30,17,6546,94,497,591,False
2011-09-30,18,6547,62,449,511,False
2011-09-30,19,6548,42,332,374,False
2011-09-30,20,6549,28,202,230,False
2011-09-30,21,6550,27,179,206,False
2011-09-30,22,6551,30,129,159,False
2011-09-30,23,6552,23,109,132,False
2011-10-01,0,6553,24,106,130,False
2011-10-01,1,6554,11,47,58,False
2011-10-01,2,6555,21,46,67,False
2011-10-01,3,6556,8,17,25,False
2011-10-01,4,6557,2,6,8,False
2011-10-01,5,6558,1,4,5,False
2011-10-01,6,6559,4,15,19,False
2011-10-01,7,6560,6,30,36,False
2011-10-01,8,6561,9,58,67,False
2011-10-01,9,6562,17,112,129,False
2011-10-01,10,6563,21,100,121,False
2011-10-01,11,6564,30,102,132,False
2011-10-01,12,6565,28,130,158,False
2011-10-01,13,6566,27,98,125,False
2011-10-01,14,6567,33,147,180,False
2011-10-01,15,6568,41,154,195,False
2011-10-01,16,6569,58,165,223,False
2011-10-01,17,6570,58,170,228,False
2011-10-01,18,6571,23,117,140,False
2011-10-01,19,6572,27,99,126,False
2011-10-01,20,6573,8,58,66,False
2011-10-01,21,6574,3,53,56,False
2011-10-01,22,6575,12,58,70,False
2011-10-01,23,6576,8,57,65,False
2011-10-02,0,6577,4,43,47,False
2011-10-02,1,6578,1,23,24,False
2011-10-02,2,6579,3,27,30,False
2011-10-02,3,6580,4,5,9,False
2011-10-02,4,6581,4,3,7,False
2011-10-02,5,6582,0,7,7,False
2011-10-02,6,6583,2,13,15,False
2011-10-02,7,6584,5,24,29,False
2011-10-02,8,6585,14,50,64,False
2011-10-02,9,6586,19,96,115,False
2011-10-02,10,6587,60,188,248,False
2011-10-02,11,6588,74,218,292,False
2011-10-02,12,6589,78,243,321,False
2011-10-02,13,6590,84,224,308,False
2011-10-02,14,6591,61,195,256,False
2011-10-02,15,6592,29,144,173,False
2011-10-02,16,6593,44,162,206,False
2011-10-02,17,6594,32,135,167,False
2011-10-02,18,6595,16,158,174,False
2011-10-02,19,6596,34,128,162,False
2011-10-02,20,6597,16,71,87,False
2011-10-02,21,6598,17,71,88,False
2011-10-02,22,6599,9,55,64,False
2011-10-02,23,6600,6,19,25,False
2011-10-03,0,6601,3,13,16,False
2011-10-03,1,6602,1,5,6,False
2011-10-03,2,6603,0,4,4,False
2011-10-03,3,6604,1,6,7,False
2011-10-03,4,6605,2,6,8,False
2011-10-03,5,6606,4,17,21,False
2011-10-03,6,6607,3,91,94,False
2011-10-03,7,6608,8,241,249,False
2011-10-03,8,6609,13,359,372,False
2011-10-03,9,6610,12,141,153,False
2011-10-03,10,6611,19,82,101,False
2011-10-03,11,6612,26,100,126,False
2011-10-03,12,6613,29,118,147,False
2011-10-03,13,6614,16,102,118,False
2011-10-03,14,6615,26,94,120,False
2011-10-03,15,6616,22,79,101,False
2011-10-03,16,6617,16,202,218,False
2011-10-03,17,6618,40,455,495,False
2011-10-03,18,6619,28,384,412,False
2011-10-03,19,6620,15,300,315,False
2011-10-03,20,6621,13,191,204,False
2011-10-03,21,6622,10,128,138,False
2011-10-03,22,6623,12,79,91,False
2011-10-03,23,6624,11,43,54,False
2011-10-04,0,6625,5,22,27,False
2011-10-04,1,6626,1,8,9,False
2011-10-04,2,6627,1,2,3,False
2011-10-04,3,6628,3,3,6,False
2011-10-04,4,6629,3,4,7,False
2011-10-04,5,6630,2,25,27,False
2011-10-04,6,6631,3,109,112,False
2011-10-04,7,6632,11,298,309,False
2011-10-04,8,6633,28,372,400,False
2011-10-04,9,6634,19,168,187,False
2011-10-04,10,6635,19,107,126,False
2011-10-04,11,6636,22,102,124,False
2011-10-04,12,6637,39,160,199,False
2011-10-04,13,6638,20,153,173,False
2011-10-04,14,6639,27,156,183,False
2011-10-04,15,6640,28,166,194,False
2011-10-04,16,6641,36,273,309,False
2011-10-04,17,6642,55,530,585,False
2011-10-04,18,6643,68,456,524,False
2011-10-04,19,6644,35,310,345,False
2011-10-04,20,6645,25,236,261,False
2011-10-04,21,6646,22,144,166,False
2011-10-04,22,6647,8,106,114,False
2011-10-04,23,6648,6,60,66,False
2011-10-05,0,6649,7,36,43,False
2011-10-05,1,6650,4,7,11,False
2011-10-05,2,6651,1,2,3,False
2011-10-05,3,6652,1,5,6,False
2011-10-05,4,6653,1,4,5,False
2011-10-05,5,6654,3,29,32,False
2011-10-05,6,6655,5,112,117,False
2011-10-05,7,6656,9,292,301,False
2011-10-05,8,6657,26,441,467,False
2011-10-05,9,6658,32,187,219,False
2011-10-05,10,6659,30,103,133,False
2011-10-05,11,6660,32,138,170,False
2011-10-05,12,6661,34,180,214,False
2011-10-05,13,6662,30,189,219,False
2011-10-05,14,6663,34,156,190,False
2011-10-05,15,6664,35,147,182,False
2011-10-05,16,6665,37,245,282,False
2011-10-05,17,6666,66,525,591,False
2011-10-05,18,6667,57,536,593,False
2011-10-05,19,6668,40,334,374,False
2011-10-05,20,6669,18,228,246,False
2011-10-05,21,6670,28,173,201,False
2011-10-05,22,6671,20,134,154,False
2011-10-05,23,6672,9,64,73,False
2011-10-06,0,6673,6,34,40,False
2011-10-06,1,6674,5,17,22,False
2011-10-06,2,6675,2,8,10,False
2011-10-06,3,6676,1,4,5,False
2011-10-06,4,6677,0,5,5,False
2011-10-06,5,6678,0,24,24,False
2011-10-06,6,6679,4,110,114,False
2011-10-06,7,6680,15,287,302,False
2011-10-06,8,6681,20,437,457,False
2011-10-06,9,6682,20,188,208,False
2011-10-06,10,6683,24,105,129,False
2011-10-06,11,6684,29,115,144,False
2011-10-06,12,6685,46,180,226,False
2011-10-06,13,6686,33,158,191,False
2011-10-06,14,6687,56,139,195,False
2011-10-06,15,6688,62,157,219,False
2011-10-06,16,6689,51,272,323,False
2011-10-06,17,6690,63,505,568,False
2011-10-06,18,6691,59,479,538,False
2011-10-06,19,6692,38,305,343,False
2011-10-06,20,6693,29,231,260,False
2011-10-06,21,6694,34,161,195,False
2011-10-06,22,6695,24,124,148,False
2011-10-06,23,6696,18,81,99,False
2011-10-07,0,6697,19,48,67,False
2011-10-07,1,6698,3,25,28,False
2011-10-07,2,6699,0,5,5,False
2011-10-07,3,6700,1,9,10,False
2011-10-07,4,6701,0,5,5,False
2011-10-07,5,6702,3,24,27,False
2011-10-07,6,6703,3,84,87,False
2011-10-07,7,6704,5,237,242,False
2011-10-07,8,6705,31,386,417,False
2011-10-07,9,6706,34,207,241,False
2011-10-07,10,6707,48,126,174,False
2011-10-07,11,6708,80,150,230,False
2011-10-07,12,6709,61,174,235,False
2011-10-07,13,6710,95,210,305,False
2011-10-07,14,6711,77,179,256,False
2011-10-07,15,6712,68,202,270,False
2011-10-07,16,6713,73,346,419,False
2011-10-07,17,6714,101,462,563,False
2011-10-07,18,6715,94,371,465,False
2011-10-07,19,6716,51,243,294,False
2011-10-07,20,6717,30,167,197,False
2011-10-07,21,6718,22,144,166,False
2011-10-07,22,6719,27,119,146,False
2011-10-07,23,6720,23,113,136,False
2011-10-08,0,6721,17,72,89,False
2011-10-08,1,6722,14,51,65,False
2011-10-08,2,6723,4,41,45,False
2011-10-08,3,6724,4,16,20,False
2011-10-08,4,6725,3,7,10,False
2011-10-08,5,6726,1,7,8,False
2011-10-08,6,6727,6,16,22,False
2011-10-08,7,6728,27,46,73,False
2011-10-08,8,6729,14,89,103,False
2011-10-08,9,6730,54,163,217,False
2011-10-08,10,6731,120,217,337,False
2011-10-08,11,6732,176,221,397,False
2011-10-08,12,6733,191,255,446,False
2011-10-08,13,6734,256,229,485,False
2011-10-08,14,6735,251,214,465,False
2011-10-08,15,6736,262,234,496,False
2011-10-08,16,6737,221,230,451,False
2011-10-08,17,6738,174,219,393,False
2011-10-08,18,6739,135,224,359,False
2011-10-08,19,6740,76,172,248,False
2011-10-08,20,6741,78,124,202,False
2011-10-08,21,6742,54,133,187,False
2011-10-08,22,6743,45,104,149,False
2011-10-08,23,6744,52,90,142,False
2011-10-09,0,6745,46,83,129,False
2011-10-09,1,6746,15,63,78,False
2011-10-09,2,6747,20,35,55,False
2011-10-09,3,6748,10,20,30,False
2011-10-09,4,6749,7,7,14,False
2011-10-09,5,6750,1,14,15,False
2011-10-09,6,6751,7,14,21,False
2011-10-09,7,6752,18,26,44,False
2011-10-09,8,6753,25,82,107,False
2011-10-09,9,6754,66,119,185,False
2011-10-09,10,6755,155,210,365,False
2011-10-09,11,6756,189,234,423,False
2011-10-09,12,6757,212,243,455,False
2011-10-09,13,6758,225,193,418,False
2011-10-09,14,6759,272,228,500,False
2011-10-09,15,6760,198,209,407,False
2011-10-09,16,6761,223,247,470,False
2011-10-09,17,6762,208,230,438,False
2011-10-09,18,6763,186,228,414,False
2011-10-09,19,6764,116,186,302,False
2011-10-09,20,6765,59,134,193,False
2011-10-09,21,6766,53,120,173,False
2011-10-09,22,6767,48,104,152,False
2011-10-09,23,6768,38,85,123,False
2011-10-10,0,6769,11,42,53,False
2011-10-10,1,6770,4,30,34,False
2011-10-10,2,6771,4,15,19,False
2011-10-10,3,6772,2,9,11,False
2011-10-10,4,6773,2,4,6,False
2011-10-10,5,6774,2,19,21,False
2011-10-10,6,6775,5,39,44,False
2011-10-10,7,6776,12,102,114,False
2011-10-10,8,6777,27,227,254,False
2011-10-10,9,6778,58,161,219,False
2011-10-10,10,6779,107,158,265,False
2011-10-10,11,6780,139,183,322,False
2011-10-10,12,6781,164,201,365,False
2011-10-10,13,6782,146,219,365,False
2011-10-10,14,6783,147,223,370,False
2011-10-10,15,6784,130,254,384,False
2011-10-10,16,6785,154,248,402,False
2011-10-10,17,6786,125,334,459,False
2011-10-10,18,6787,108,365,473,False
2011-10-10,19,6788,69,267,336,False
2011-10-10,20,6789,37,188,225,False
2011-10-10,21,6790,27,148,175,False
2011-10-10,22,6791,22,104,126,False
2011-10-10,23,6792,12,63,75,False
2011-10-11,0,6793,14,16,30,False
2011-10-11,1,6794,2,9,11,False
2011-10-11,2,6795,1,4,5,False
2011-10-11,3,6796,2,1,3,False
2011-10-11,4,6797,0,5,5,False
2011-10-11,5,6798,0,20,20,False
2011-10-11,6,6799,9,114,123,False
2011-10-11,7,6800,19,333,352,False
2011-10-11,8,6801,31,375,406,False
2011-10-11,9,6802,40,195,235,False
2011-10-11,10,6803,38,111,149,False
2011-10-11,11,6804,31,92,123,False
2011-10-11,12,6805,51,130,181,False
2011-10-11,13,6806,42,138,180,False
2011-10-11,14,6807,54,117,171,False
2011-10-11,15,6808,36,139,175,False
2011-10-11,16,6809,63,257,320,False
2011-10-11,17,6810,70,534,604,False
2011-10-11,18,6811,46,493,539,False
2011-10-11,19,6812,33,285,318,False
2011-10-11,20,6813,31,203,234,False
2011-10-11,21,6814,17,158,175,False
2011-10-11,22,6815,27,120,147,False
2011-10-11,23,6816,10,47,57,False
2011-10-12,0,6817,2,23,25,False
2011-10-12,1,6818,2,8,10,False
2011-10-12,2,6819,0,2,2,False
2011-10-12,3,6820,0,2,2,False
2011-10-12,4,6821,1,6,7,False
2011-10-12,5,6822,0,22,22,False
2011-10-12,6,6823,5,107,112,False
2011-10-12,7,6824,15,244,259,False
2011-10-12,8,6825,27,377,404,False
2011-10-12,9,6826,14,183,197,False
2011-10-12,10,6827,15,98,113,False
2011-10-12,11,6828,18,102,120,False
2011-10-12,12,6829,9,53,62,False
2011-10-12,13,6830,25,76,101,False
2011-10-12,14,6831,8,70,78,False
2011-10-12,15,6832,3,42,45,False
2011-10-12,16,6833,5,50,55,False
2011-10-12,17,6834,16,235,251,False
2011-10-12,18,6835,11,161,172,False
2011-10-12,19,6836,7,102,109,False
2011-10-12,20,6837,9,81,90,False
2011-10-12,21,6838,9,74,83,False
2011-10-12,22,6839,3,40,43,False
2011-10-12,23,6840,13,41,54,False
2011-10-13,0,6841,1,14,15,False
2011-10-13,1,6842,3,9,12,False
2011-10-13,2,6843,0,4,4,False
2011-10-13,3,6844,2,4,6,False
2011-10-13,4,6845,2,5,7,False
2011-10-13,5,6846,1,16,17,False
2011-10-13,6,6847,1,51,52,False
2011-10-13,7,6848,5,76,81,False
2011-10-13,8,6849,10,199,209,False
2011-10-13,9,6850,3,106,109,False
2011-10-13,10,6851,16,53,69,False
2011-10-13,11,6852,8,76,84,False
2011-10-13,12,6853,10,95,105,False
2011-10-13,13,6854,20,142,162,False
2011-10-13,14,6855,22,111,133,False
2011-10-13,15,6856,27,128,155,False
2011-10-13,16,6857,36,240,276,False
2011-10-13,17,6858,47,432,479,False
2011-10-13,18,6859,20,248,268,False
2011-10-13,19,6860,18,187,205,False
2011-10-13,20,6861,15,166,181,False
2011-10-13,21,6862,8,115,123,False
2011-10-13,22,6863,13,101,114,False
2011-10-13,23,6864,2,45,47,False
2011-10-14,0,6865,10,29,39,False
2011-10-14,1,6866,8,16,24,False
2011-10-14,2,6867,0,6,6,False
2011-10-14,3,6868,1,6,7,False
2011-10-14,4,6869,0,8,8,False
2011-10-14,5,6870,0,17,17,False
2011-10-14,6,6871,4,90,94,False
2011-10-14,7,6872,10,137,147,False
2011-10-14,8,6873,23,186,209,False
2011-10-14,9,6874,16,164,180,False
2011-10-14,10,6875,17,108,125,False
2011-10-14,11,6876,11,76,87,False
2011-10-14,12,6877,13,62,75,False
2011-10-14,13,6878,18,114,132,False
2011-10-14,14,6879,37,119,156,False
2011-10-14,15,6880,61,169,230,False
2011-10-14,16,6881,80,264,344,False
2011-10-14,17,6882,55,426,481,False
2011-10-14,18,6883,62,361,423,False
2011-10-14,19,6884,27,221,248,False
2011-10-14,20,6885,19,177,196,False
2011-10-14,21,6886,22,156,178,False
2011-10-14,22,6887,20,123,143,False
2011-10-14,23,6888,15,80,95,False
2011-10-15,0,6889,18,88,106,False
2011-10-15,1,6890,9,64,73,False
2011-10-15,2,6891,17,39,56,False
2011-10-15,3,6892,5,18,23,False
2011-10-15,4,6893,0,6,6,False
2011-10-15,5,6894,1,6,7,False
2011-10-15,6,6895,5,15,20,False
2011-10-15,7,6896,17,40,57,False
2011-10-15,8,6897,24,101,125,False
2011-10-15,9,6898,50,157,207,False
2011-10-15,10,6899,115,207,322,False
2011-10-15,11,6900,153,221,374,False
2011-10-15,12,6901,195,261,456,False
2011-10-15,13,6902,171,223,394,False
2011-10-15,14,6903,242,230,472,False
2011-10-15,15,6904,166,211,377,False
2011-10-15,16,6905,179,264,443,False
2011-10-15,17,6906,177,264,441,False
2011-10-15,18,6907,121,251,372,False
2011-10-15,19,6908,61,177,238,False
2011-10-15,20,6909,42,137,179,False
2011-10-15,21,6910,53,115,168,False
2011-10-15,22,6911,45,121,166,False
2011-10-15,23,6912,33,102,135,False
2011-10-16,0,6913,22,85,107,False
2011-10-16,1,6914,13,64,77,False
2011-10-16,2,6915,13,52,65,False
2011-10-16,3,6916,11,31,42,False
2011-10-16,4,6917,5,7,12,False
2011-10-16,5,6918,1,6,7,False
2011-10-16,6,6919,3,7,10,False
2011-10-16,7,6920,9,39,48,False
2011-10-16,8,6921,28,71,99,False
2011-10-16,9,6922,39,151,190,False
2011-10-16,10,6923,121,226,347,False
2011-10-16,11,6924,159,218,377,False
2011-10-16,12,6925,167,277,444,False
2011-10-16,13,6926,169,269,438,False
2011-10-16,14,6927,204,258,462,False
2011-10-16,15,6928,182,230,412,False
2011-10-16,16,6929,177,289,466,False
2011-10-16,17,6930,152,253,405,False
2011-10-16,18,6931,102,226,328,False
2011-10-16,19,6932,52,181,233,False
2011-10-16,20,6933,49,129,178,False
2011-10-16,21,6934,14,88,102,False
2011-10-16,22,6935,42,88,130,False
2011-10-16,23,6936,14,48,62,False
2011-10-17,0,6937,12,25,37,False
2011-10-17,1,6938,2,15,17,False
2011-10-17,2,6939,4,3,7,False
2011-10-17,3,6940,0,2,2,False
2011-10-17,4,6941,2,3,5,False
2011-10-17,5,6942,1,28,29,False
2011-10-17,6,6943,7,107,114,False
2011-10-17,7,6944,10,299,309,False
2011-10-17,8,6945,33,381,414,False
2011-10-17,9,6946,26,180,206,False
2011-10-17,10,6947,43,92,135,False
2011-10-17,11,6948,35,131,166,False
2011-10-17,12,6949,39,166,205,False
2011-10-17,13,6950,49,156,205,False
2011-10-17,14,6951,44,122,166,False
2011-10-17,15,6952,66,142,208,False
2011-10-17,16,6953,64,238,302,False
2011-10-17,17,6954,80,540,620,False
2011-10-17,18,6955,49,469,518,False
2011-10-17,19,6956,45,288,333,False
2011-10-17,20,6957,40,189,229,False
2011-10-17,21,6958,36,141,177,False
2011-10-17,22,6959,16,88,104,False
2011-10-17,23,6960,10,52,62,False
2011-10-18,0,6961,8,23,31,False
2011-10-18,1,6962,4,7,11,False
2011-10-18,2,6963,1,4,5,False
2011-10-18,3,6964,0,1,1,False
2011-10-18,4,6965,0,4,4,False
2011-10-18,5,6966,2,19,21,False
2011-10-18,6,6967,4,105,109,False
2011-10-18,7,6968,15,326,341,False
2011-10-18,8,6969,25,474,499,False
2011-10-18,9,6970,29,198,227,False
2011-10-18,10,6971,27,75,102,False
2011-10-18,11,6972,35,112,147,False
2011-10-18,12,6973,42,159,201,False
2011-10-18,13,6974,48,171,219,False
2011-10-18,14,6975,32,137,169,False
2011-10-18,15,6976,66,139,205,False
2011-10-18,16,6977,58,246,304,False
2011-10-18,17,6978,72,553,625,False
2011-10-18,18,6979,58,512,570,False
2011-10-18,19,6980,31,286,317,False
2011-10-18,20,6981,23,204,227,False
2011-10-18,21,6982,28,178,206,False
2011-10-18,22,6983,22,115,137,False
2011-10-18,23,6984,7,63,70,False
2011-10-19,0,6985,11,23,34,False
2011-10-19,1,6986,7,9,16,False
2011-10-19,2,6987,1,6,7,False
2011-10-19,3,6988,3,9,12,True
2011-10-19,4,6989,0,3,3,False
2011-10-19,5,6990,0,3,3,False
2011-10-19,6,6991,3,28,31,False
2011-10-19,7,6992,1,67,68,False
2011-10-19,8,6993,10,200,210,False
2011-10-19,9,6994,17,185,202,False
2011-10-19,10,6995,14,109,123,False
2011-10-19,11,6996,33,116,149,False
2011-10-19,12,6997,13,117,130,False
2011-10-19,13,6998,20,86,106,False
2011-10-19,14,6999,17,80,97,False
2011-10-19,15,7000,21,99,120,False
2011-10-19,16,7001,21,180,201,False
2011-10-19,17,7002,11,170,181,False
2011-10-19,18,7003,8,132,140,False
2011-10-19,19,7004,8,189,197,False
2011-10-19,20,7005,5,140,145,False
2011-10-19,21,7006,6,79,85,False
2011-10-19,22,7007,13,94,107,False
2011-10-19,23,7008,14,55,69,False
2011-10-20,0,7009,4,22,26,False
2011-10-20,1,7010,4,11,15,False
2011-10-20,2,7011,0,4,4,False
2011-10-20,3,7012,0,1,1,False
2011-10-20,4,7013,2,6,8,False
2011-10-20,5,7014,2,24,26,False
2011-10-20,6,7015,5,87,92,False
2011-10-20,7,7016,15,303,318,False
2011-10-20,8,7017,17,409,426,False
2011-10-20,9,7018,26,197,223,False
2011-10-20,10,7019,25,105,130,False
2011-10-20,11,7020,30,99,129,False
2011-10-20,12,7021,28,171,199,False
2011-10-20,13,7022,28,136,164,False
2011-10-20,14,7023,38,117,155,False
2011-10-20,15,7024,22,138,160,False
2011-10-20,16,7025,31,203,234,False
2011-10-20,17,7026,56,438,494,False
2011-10-20,18,7027,39,430,469,False
2011-10-20,19,7028,20,278,298,False
2011-10-20,20,7029,34,207,241,False
2011-10-20,21,7030,16,149,165,False
2011-10-20,22,7031,22,106,128,False
2011-10-20,23,7032,7,83,90,False
2011-10-21,0,7033,8,42,50,False
2011-10-21,1,7034,7,19,26,False
2011-10-21,2,7035,6,12,18,False
2011-10-21,3,7036,0,7,7,False
2011-10-21,4,7037,0,6,6,False
2011-10-21,5,7038,0,31,31,False
2011-10-21,6,7039,7,78,85,False
2011-10-21,7,7040,5,228,233,False
2011-10-21,8,7041,16,386,402,False
2011-10-21,9,7042,33,189,222,False
2011-10-21,10,7043,32,106,138,False
2011-10-21,11,7044,39,135,174,False
2011-10-21,12,7045,47,193,240,False
2011-10-21,13,7046,43,163,206,False
2011-10-21,14,7047,67,131,198,False
2011-10-21,15,7048,57,178,235,False
2011-10-21,16,7049,60,242,302,False
2011-10-21,17,7050,79,445,524,False
2011-10-21,18,7051,43,354,397,False
2011-10-21,19,7052,25,228,253,False
2011-10-21,20,7053,29,155,184,False
2011-10-21,21,7054,31,112,143,False
2011-10-21,22,7055,24,89,113,False
2011-10-21,23,7056,18,99,117,False
2011-10-22,0,7057,16,80,96,False
2011-10-22,1,7058,20,50,70,False
2011-10-22,2,7059,6,25,31,False
2011-10-22,3,7060,1,19,20,False
2011-10-22,4,7061,4,4,8,False
2011-10-22,5,7062,1,7,8,False
2011-10-22,6,7063,1,17,18,False
2011-10-22,7,7064,8,49,57,False
2011-10-22,8,7065,26,88,114,False
2011-10-22,9,7066,47,122,169,False
2011-10-22,10,7067,87,149,236,False
2011-10-22,11,7068,110,172,282,False
2011-10-22,12,7069,132,211,343,False
2011-10-22,13,7070,136,186,322,False
2011-10-22,14,7071,133,177,310,False
2011-10-22,15,7072,159,223,382,False
2011-10-22,16,7073,169,190,359,False
2011-10-22,17,7074,143,217,360,False
2011-10-22,18,7075,111,224,335,False
2011-10-22,19,7076,47,173,220,False
2011-10-22,20,7077,48,111,159,False
2011-10-22,21,7078,37,120,157,False
2011-10-22,22,7079,30,114,144,False
2011-10-22,23,7080,27,81,108,False
2011-10-23,0,7081,24,64,88,False
2011-10-23,1,7082,11,60,71,False
2011-10-23,2,7083,10,40,50,False
2011-10-23,3,7084,15,31,46,False
2011-10-23,4,7085,5,1,6,False
2011-10-23,5,7086,1,2,3,False
2011-10-23,6,7087,0,12,12,False
2011-10-23,7,7088,3,18,21,False
2011-10-23,8,7089,32,56,88,False
2011-10-23,9,7090,48,95,143,False
2011-10-23,10,7091,104,185,289,False
2011-10-23,11,7092,131,202,333,False
2011-10-23,12,7093,164,249,413,False
2011-10-23,13,7094,160,255,415,False
2011-10-23,14,7095,192,216,408,False
2011-10-23,15,7096,171,216,387,False
2011-10-23,16,7097,188,217,405,False
2011-10-23,17,7098,120,220,340,False
2011-10-23,18,7099,88,196,284,False
2011-10-23,19,7100,53,140,193,False
2011-10-23,20,7101,32,112,144,False
2011-10-23,21,7102,24,75,99,False
2011-10-23,22,7103,25,69,94,False
2011-10-23,23,7104,18,31,49,False
2011-10-24,0,7105,6,26,32,False
2011-10-24,1,7106,7,8,15,False
2011-10-24,2,7107,1,6,7,False
2011-10-24,3,7108,1,3,4,False
2011-10-24,4,7109,1,5,6,False
2011-10-24,5,7110,2,19,21,False
2011-10-24,6,7111,3,83,86,False
2011-10-24,7,7112,11,274,285,False
2011-10-24,8,7113,20,378,398,False
2011-10-24,9,7114,29,166,195,False
2011-10-24,10,7115,47,82,129,False
2011-10-24,11,7116,59,109,168,False
2011-10-24,12,7117,64,156,220,False
2011-10-24,13,7118,60,138,198,False
2011-10-24,14,7119,63,143,206,False
2011-10-24,15,7120,52,125,177,False
2011-10-24,16,7121,68,242,310,False
2011-10-24,17,7122,87,527,614,False
2011-10-24,18,7123,58,428,486,False
2011-10-24,19,7124,25,212,237,False
2011-10-24,20,7125,11,118,129,False
2011-10-24,21,7126,12,114,126,False
2011-10-24,22,7127,3,76,79,False
2011-10-24,23,7128,9,50,59,False
2011-10-25,0,7129,4,26,30,False
2011-10-25,1,7130,5,6,11,False
2011-10-25,2,7131,2,3,5,False
2011-10-25,3,7132,1,3,4,False
2011-10-25,4,7133,0,5,5,False
2011-10-25,5,7134,0,24,24,False
2011-10-25,6,7135,3,95,98,False
2011-10-25,7,7136,15,299,314,False
2011-10-25,8,7137,25,383,408,False
2011-10-25,9,7138,29,194,223,False
2011-10-25,10,7139,26,102,128,False
2011-10-25,11,7140,46,120,166,False
2011-10-25,12,7141,35,165,200,False
2011-10-25,13,7142,37,161,198,False
2011-10-25,14,7143,66,134,200,False
2011-10-25,15,7144,63,171,234,False
2011-10-25,16,7145,52,233,285,False
2011-10-25,17,7146,68,517,585,False
2011-10-25,18,7147,65,453,518,False
2011-10-25,19,7148,44,294,338,False
2011-10-25,20,7149,40,208,248,False
2011-10-25,21,7150,32,169,201,False
2011-10-25,22,7151,22,148,170,False
2011-10-25,23,7152,15,79,94,False
2011-10-26,0,7153,4,28,32,False
2011-10-26,1,7154,3,9,12,False
2011-10-26,2,7155,2,1,3,False
2011-10-26,3,7156,0,3,3,False
2011-10-26,4,7157,0,5,5,False
2011-10-26,5,7158,0,21,21,False
2011-10-26,6,7159,0,92,92,False
2011-10-26,7,7160,15,284,299,False
2011-10-26,8,7161,26,438,464,False
2011-10-26,9,7162,14,226,240,False
2011-10-26,10,7163,26,105,131,False
2011-10-26,11,7164,23,132,155,False
2011-10-26,12,7165,39,155,194,False
2011-10-26,13,7166,20,62,82,False
2011-10-26,14,7167,14,52,66,False
2011-10-26,15,7168,11,59,70,False
2011-10-26,16,7169,17,196,213,False
2011-10-26,17,7170,40,414,454,False
2011-10-26,18,7171,55,398,453,False
2011-10-26,19,7172,25,306,331,False
2011-10-26,20,7173,27,180,207,False
2011-10-26,21,7174,17,140,157,False
2011-10-26,22,7175,23,112,135,False
2011-10-26,23,7176,3,72,75,False
2011-10-27,0,7177,3,23,26,False
2011-10-27,1,7178,2,9,11,False
2011-10-27,2,7179,3,5,8,False
2011-10-27,3,7180,1,3,4,False
2011-10-27,4,7181,1,3,4,False
2011-10-27,5,7182,1,14,15,False
2011-10-27,6,7183,4,42,46,False
2011-10-27,7,7184,9,128,137,False
2011-10-27,8,7185,12,304,316,False
2011-10-27,9,7186,16,155,171,False
2011-10-27,10,7187,10,52,62,False
2011-10-27,11,7188,8,44,52,False
2011-10-27,12,7189,8,45,53,False
2011-10-27,13,7190,10,64,74,False
2011-10-27,14,7191,16,76,92,False
2011-10-27,15,7192,12,95,107,False
2011-10-27,16,7193,14,193,207,False
2011-10-27,17,7194,31,291,322,False
2011-10-27,18,7195,14,226,240,False
2011-10-27,19,7196,19,200,219,False
2011-10-27,20,7197,11,171,182,False
2011-10-27,21,7198,13,119,132,False
2011-10-27,22,7199,14,97,111,False
2011-10-27,23,7200,8,60,68,False
2011-10-28,0,7201,4,40,44,False
2011-10-28,1,7202,7,9,16,False
2011-10-28,2,7203,1,3,4,False
2011-10-28,3,7204,4,4,8,False
2011-10-28,4,7205,5,5,10,False
2011-10-28,5,7206,0,25,25,False
2011-10-28,6,7207,1,74,75,False
2011-10-28,7,7208,6,199,205,False
2011-10-28,8,7209,13,361,374,False
2011-10-28,9,7210,19,210,229,False
2011-10-28,10,7211,28,102,130,False
2011-10-28,11,7212,40,128,168,False
2011-10-28,12,7213,46,167,213,False
2011-10-28,13,7214,43,185,228,False
2011-10-28,14,7215,33,152,185,False
2011-10-28,15,7216,44,171,215,False
2011-10-28,16,7217,46,262,308,False
2011-10-28,17,7218,35,411,446,False
2011-10-28,18,7219,36,332,368,False
2011-10-28,19,7220,16,188,204,False
2011-10-28,20,7221,12,131,143,False
2011-10-28,21,7222,5,69,74,False
2011-10-28,22,7223,4,32,36,False
2011-10-28,23,7224,8,31,39,False
2011-10-29,0,7225,0,19,19,False
2011-10-29,1,7226,0,18,18,False
2011-10-29,2,7227,1,16,17,False
2011-10-29,3,7228,0,8,8,False
2011-10-29,4,7229,0,1,1,False
2011-10-29,5,7230,0,1,1,False
2011-10-29,6,7231,4,1,5,False
2011-10-29,7,7232,1,6,7,False
2011-10-29,8,7233,4,16,20,False
2011-10-29,9,7234,1,19,20,False
2011-10-29,10,7235,0,12,12,False
2011-10-29,11,7236,1,26,27,False
2011-10-29,12,7237,6,44,50,False
2011-10-29,13,7238,0,30,30,False
2011-10-29,14,7239,0,29,29,False
2011-10-29,15,7240,3,38,41,False
2011-10-29,16,7241,3,19,22,False
2011-10-29,17,7242,3,28,31,False
2011-10-29,18,7243,6,37,43,False
2011-10-29,19,7244,3,36,39,False
2011-10-29,20,7245,7,40,47,False
2011-10-29,21,7246,1,49,50,False
2011-10-29,22,7247,10,44,54,False
2011-10-29,23,7248,3,33,36,False
2011-10-30,0,7249,7,47,54,False
2011-10-30,1,7250,9,34,43,False
2011-10-30,2,7251,7,43,50,False
2011-10-30,3,7252,7,26,33,False
2011-10-30,4,7253,1,10,11,False
2011-10-30,5,7254,0,4,4,False
2011-10-30,6,7255,2,8,10,False
2011-10-30,7,7256,7,15,22,False
2011-10-30,8,7257,20,60,80,False
2011-10-30,9,7258,55,92,147,False
2011-10-30,10,7259,53,125,178,False
2011-10-30,11,7260,58,182,240,False
2011-10-30,12,7261,85,229,314,False
2011-10-30,13,7262,113,232,345,False
2011-10-30,14,7263,91,209,300,False
2011-10-30,15,7264,88,202,290,False
2011-10-30,16,7265,107,213,320,False
2011-10-30,17,7266,54,191,245,False
2011-10-30,18,7267,51,162,213,False
2011-10-30,19,7268,28,125,153,False
2011-10-30,20,7269,18,74,92,False
2011-10-30,21,7270,4,75,79,False
2011-10-30,22,7271,13,58,71,False
2011-10-30,23,7272,7,30,37,False
2011-10-31,0,7273,3,20,23,False
2011-10-31,1,7274,5,8,13,False
2011-10-31,2,7275,0,3,3,False
2011-10-31,3,7276,0,3,3,False
2011-10-31,4,7277,1,5,6,False
2011-10-31,5,7278,0,18,18,False
2011-10-31,6,7279,4,82,86,False
2011-10-31,7,7280,11,216,227,False
2011-10-31,8,7281,17,355,372,False
2011-10-31,9,7282,14,197,211,False
2011-10-31,10,7283,18,87,105,False
2011-10-31,11,7284,31,97,128,False
2011-10-31,12,7285,30,140,170,False
2011-10-31,13,7286,24,128,152,False
2011-10-31,14,7287,22,119,141,False
2011-10-31,15,7288,27,141,168,False
2011-10-31,16,7289,30,242,272,False
2011-10-31,17,7290,44,442,486,False
2011-10-31,18,7291,30,392,422,False
2011-10-31,19,7292,12,226,238,False
2011-10-31,20,7293,18,154,172,False
2011-10-31,21,7294,7,109,116,False
2011-10-31,22,7295,8,77,85,False
2011-10-31,23,7296,6,46,52,False
2011-11-01,0,7297,3,18,21,False
2011-11-01,1,7298,3,8,11,False
2011-11-01,2,7299,1,3,4,False
2011-11-01,3,7300,1,5,6,False
2011-11-01,4,7301,1,7,8,False
2011-11-01,5,7302,0,18,18,False
2011-11-01,6,7303,3,90,93,False
2011-11-01,7,7304,8,246,254,False
2011-11-01,8,7305,17,402,419,False
2011-11-01,9,7306,16,206,222,False
2011-11-01,10,7307,21,114,135,False
2011-11-01,11,7308,16,101,117,False
2011-11-01,12,7309,23,153,176,False
2011-11-01,13,7310,20,147,167,False
2011-11-01,14,7311,32,118,150,False
2011-11-01,15,7312,38,148,186,False
2011-11-01,16,7313,46,252,298,False
2011-11-01,17,7314,36,470,506,False
2011-11-01,18,7315,39,421,460,False
2011-11-01,19,7316,39,274,313,False
2011-11-01,20,7317,18,191,209,False
2011-11-01,21,7318,13,114,127,False
2011-11-01,22,7319,5,91,96,False
2011-11-01,23,7320,11,61,72,False
2011-11-02,0,7321,0,19,19,False
2011-11-02,1,7322,2,8,10,False
2011-11-02,2,7323,0,2,2,False
2011-11-02,3,7324,0,2,2,False
2011-11-02,4,7325,0,4,4,False
2011-11-02,5,7326,0,27,27,False
2011-11-02,6,7327,1,91,92,False
2011-11-02,7,7328,11,240,251,False
2011-11-02,8,7329,20,452,472,False
2011-11-02,9,7330,15,213,228,False
2011-11-02,10,7331,25,108,133,False
2011-11-02,11,7332,27,117,144,False
2011-11-02,12,7333,32,157,189,False
2011-11-02,13,7334,22,139,161,False
2011-11-02,14,7335,40,132,172,False
2011-11-02,15,7336,26,161,187,False
2011-11-02,16,7337,35,231,266,False
2011-11-02,17,7338,30,523,553,False
2011-11-02,18,7339,31,448,479,False
2011-11-02,19,7340,25,257,282,False
2011-11-02,20,7341,5,177,182,False
2011-11-02,21,7342,13,155,168,False
2011-11-02,22,7343,7,99,106,False
2011-11-02,23,7344,3,54,57,False
2011-11-03,0,7345,3,28,31,False
2011-11-03,1,7346,3,12,15,False
2011-11-03,2,7347,2,5,7,False
2011-11-03,3,7348,1,4,5,False
2011-11-03,4,7349,1,3,4,False
2011-11-03,5,7350,1,27,28,False
2011-11-03,6,7351,3,96,99,False
2011-11-03,7,7352,12,280,292,False
2011-11-03,8,7353,8,394,402,False
2011-11-03,9,7354,9,155,164,False
2011-11-03,10,7355,12,98,110,False
2011-11-03,11,7356,12,108,120,False
2011-11-03,12,7357,17,162,179,False
2011-11-03,13,7358,19,150,169,False
2011-11-03,14,7359,32,120,152,False
2011-11-03,15,7360,24,138,162,False
2011-11-03,16,7361,33,234,267,False
2011-11-03,17,7362,33,465,498,False
2011-11-03,18,7363,24,409,433,False
2011-11-03,19,7364,18,234,252,False
2011-11-03,20,7365,11,198,209,False
2011-11-03,21,7366,4,140,144,False
2011-11-03,22,7367,21,116,137,False
2011-11-03,23,7368,15,80,95,False
2011-11-04,0,7369,11,32,43,False
2011-11-04,1,7370,1,16,17,False
2011-11-04,2,7371,2,8,10,False
2011-11-04,3,7372,1,7,8,False
2011-11-04,4,7373,1,6,7,False
2011-11-04,5,7374,0,23,23,False
2011-11-04,6,7375,2,64,66,False
2011-11-04,7,7376,10,235,245,False
2011-11-04,8,7377,8,387,395,False
2011-11-04,9,7378,15,239,254,False
2011-11-04,10,7379,19,115,134,False
2011-11-04,11,7380,34,128,162,False
2011-11-04,12,7381,44,153,197,False
2011-11-04,13,7382,33,161,194,False
2011-11-04,14,7383,54,147,201,False
2011-11-04,15,7384,45,192,237,False
2011-11-04,16,7385,53,237,290,False
2011-11-04,17,7386,42,438,480,False
2011-11-04,18,7387,35,339,374,False
2011-11-04,19,7388,14,182,196,False
2011-11-04,20,7389,15,171,186,False
2011-11-04,21,7390,8,115,123,False
2011-11-04,22,7391,6,109,115,False
2011-11-04,23,7392,17,72,89,False
2011-11-05,0,7393,4,48,52,False
2011-11-05,1,7394,5,57,62,False
2011-11-05,2,7395,7,24,31,False
2011-11-05,3,7396,0,8,8,False
2011-11-05,4,7397,3,5,8,False
2011-11-05,5,7398,0,2,2,False
2011-11-05,6,7399,3,20,23,False
2011-11-05,7,7400,3,31,34,False
2011-11-05,8,7401,4,80,84,False
2011-11-05,9,7402,30,111,141,False
2011-11-05,10,7403,56,171,227,False
2011-11-05,11,7404,69,169,238,False
2011-11-05,12,7405,137,235,372,False
2011-11-05,13,7406,148,207,355,False
2011-11-05,14,7407,159,227,386,False
2011-11-05,15,7408,141,202,343,False
2011-11-05,16,7409,128,207,335,False
2011-11-05,17,7410,100,234,334,False
2011-11-05,18,7411,52,185,237,False
2011-11-05,19,7412,45,159,204,False
2011-11-05,20,7413,29,136,165,False
2011-11-05,21,7414,19,99,118,False
2011-11-05,22,7415,10,72,82,False
2011-11-05,23,7416,4,81,85,False
2011-11-06,0,7417,10,65,75,False
2011-11-06,1,7418,11,104,115,False
2011-11-06,2,7419,6,23,29,False
2011-11-06,3,7420,5,4,9,False
2011-11-06,4,7421,0,6,6,False
2011-11-06,5,7422,0,5,5,False
2011-11-06,6,7423,5,11,16,False
2011-11-06,7,7424,4,24,28,False
2011-11-06,8,7425,19,71,90,False
2011-11-06,9,7426,36,134,170,False
2011-11-06,10,7427,76,186,262,False
2011-11-06,11,7428,104,216,320,False
2011-11-06,12,7429,120,226,346,False
2011-11-06,13,7430,105,209,314,False
2011-11-06,14,7431,101,219,320,False
2011-11-06,15,7432,96,210,306,False
2011-11-06,16,7433,84,263,347,False
2011-11-06,17,7434,71,185,256,False
2011-11-06,18,7435,39,146,185,False
2011-11-06,19,7436,21,130,151,False
2011-11-06,20,7437,16,100,116,False
2011-11-06,21,7438,11,77,88,False
2011-11-06,22,7439,5,40,45,False
2011-11-06,23,7440,7,43,50,False
2011-11-07,0,7441,1,14,15,False
2011-11-07,1,7442,2,6,8,False
2011-11-07,2,7443,0,2,2,False
2011-11-07,3,7444,0,3,3,False
2011-11-07,4,7445,2,4,6,False
2011-11-07,5,7446,1,25,26,False
2011-11-07,6,7447,2,97,99,False
2011-11-07,7,7448,6,305,311,False
2011-11-07,8,7449,13,397,410,False
2011-11-07,9,7450,18,156,174,False
2011-11-07,10,7451,28,95,123,False
2011-11-07,11,7452,28,100,128,False
2011-11-07,12,7453,21,158,179,False
2011-11-07,13,7454,32,157,189,False
2011-11-07,14,7455,30,115,145,False
2011-11-07,15,7456,38,132,170,False
2011-11-07,16,7457,40,255,295,False
2011-11-07,17,7458,39,489,528,False
2011-11-07,18,7459,18,407,425,False
2011-11-07,19,7460,20,280,300,False
2011-11-07,20,7461,17,187,204,False
2011-11-07,21,7462,10,129,139,False
2011-11-07,22,7463,6,102,108,False
2011-11-07,23,7464,1,47,48,False
2011-11-08,0,7465,0,18,18,False
2011-11-08,1,7466,3,8,11,False
2011-11-08,2,7467,0,1,1,False
2011-11-08,3,7468,0,3,3,False
2011-11-08,4,7469,0,4,4,False
2011-11-08,5,7470,1,17,18,False
2011-11-08,6,7471,3,96,99,False
2011-11-08,7,7472,7,316,323,False
2011-11-08,8,7473,11,455,466,False
2011-11-08,9,7474,14,177,191,False
2011-11-08,10,7475,25,104,129,False
2011-11-08,11,7476,21,126,147,False
2011-11-08,12,7477,28,175,203,False
2011-11-08,13,7478,31,165,196,False
2011-11-08,14,7479,32,129,161,False
2011-11-08,15,7480,33,155,188,False
2011-11-08,16,7481,39,250,289,False
2011-11-08,17,7482,40,459,499,False
2011-11-08,18,7483,30,432,462,False
2011-11-08,19,7484,14,264,278,False
2011-11-08,20,7485,12,169,181,False
2011-11-08,21,7486,16,166,182,False
2011-11-08,22,7487,13,95,108,False
2011-11-08,23,7488,3,45,48,False
2011-11-09,0,7489,0,13,13,False
2011-11-09,1,7490,0,10,10,False
2011-11-09,2,7491,0,5,5,False
2011-11-09,3,7492,0,4,4,False
2011-11-09,4,7493,0,4,4,False
2011-11-09,5,7494,0,28,28,False
2011-11-09,6,7495,0,98,98,False
2011-11-09,7,7496,0,300,300,False
2011-11-09,8,7497,19,437,456,False
2011-11-09,9,7498,22,197,219,False
2011-11-09,10,7499,16,89,105,False
2011-11-09,11,7500,21,131,152,False
2011-11-09,12,7501,24,156,180,False
2011-11-09,13,7502,31,136,167,False
2011-11-09,14,7503,26,153,179,False
2011-11-09,15,7504,21,130,151,False
2011-11-09,16,7505,24,257,281,False
2011-11-09,17,7506,27,458,485,False
2011-11-09,18,7507,21,387,408,False
2011-11-09,19,7508,12,292,304,False
2011-11-09,20,7509,18,201,219,False
2011-11-09,21,7510,9,152,161,False
2011-11-09,22,7511,9,105,114,False
2011-11-09,23,7512,5,61,66,False
2011-11-10,0,7513,0,24,24,False
2011-11-10,1,7514,1,10,11,False
2011-11-10,2,7515,0,5,5,False
2011-11-10,3,7516,0,11,11,False
2011-11-10,4,7517,1,2,3,False
2011-11-10,5,7518,1,22,23,False
2011-11-10,6,7519,4,110,114,False
2011-11-10,7,7520,6,266,272,False
2011-11-10,8,7521,18,418,436,False
2011-11-10,9,7522,23,188,211,False
2011-11-10,10,7523,17,100,117,False
2011-11-10,11,7524,9,99,108,False
2011-11-10,12,7525,18,149,167,False
2011-11-10,13,7526,9,87,96,False
2011-11-10,14,7527,6,58,64,False
2011-11-10,15,7528,5,57,62,False
2011-11-10,16,7529,6,67,73,False
2011-11-10,17,7530,9,168,177,False
2011-11-10,18,7531,10,263,273,False
2011-11-10,19,7532,19,192,211,False
2011-11-10,20,7533,8,160,168,False
2011-11-10,21,7534,6,130,136,False
2011-11-10,22,7535,5,84,89,False
2011-11-10,23,7536,9,73,82,False
2011-11-11,0,7537,10,56,66,False
2011-11-11,1,7538,3,16,19,False
2011-11-11,2,7539,1,10,11,False
2011-11-11,3,7540,0,6,6,False
2011-11-11,4,7541,0,8,8,False
2011-11-11,5,7542,0,13,13,False
2011-11-11,6,7543,0,46,46,False
2011-11-11,7,7544,5,116,121,False
2011-11-11,8,7545,9,249,258,False
2011-11-11,9,7546,15,186,201,False
2011-11-11,10,7547,38,162,200,False
2011-11-11,11,7548,20,150,170,False
2011-11-11,12,7549,41,198,239,False
2011-11-11,13,7550,57,179,236,False
2011-11-11,14,7551,64,183,247,False
2011-11-11,15,7552,29,187,216,False
2011-11-11,16,7553,49,189,238,False
2011-11-11,17,7554,24,286,310,False
2011-11-11,18,7555,23,185,208,False
2011-11-11,19,7556,17,182,199,False
2011-11-11,20,7557,12,97,109,False
2011-11-11,21,7558,4,79,83,False
2011-11-11,22,7559,13,78,91,False
2011-11-11,23,7560,6,67,73,False
2011-11-12,0,7561,12,52,64,False
2011-11-12,1,7562,9,45,54,False
2011-11-12,2,7563,7,39,46,False
2011-11-12,3,7564,4,13,17,False
2011-11-12,4,7565,0,7,7,False
2011-11-12,5,7566,1,3,4,False
2011-11-12,6,7567,0,7,7,False
2011-11-12,7,7568,3,24,27,False
2011-11-12,8,7569,14,87,101,False
2011-11-12,9,7570,18,142,160,False
2011-11-12,10,7571,62,170,232,False
2011-11-12,11,7572,102,213,315,False
2011-11-12,12,7573,142,224,366,False
2011-11-12,13,7574,128,225,353,False
2011-11-12,14,7575,191,244,435,False
2011-11-12,15,7576,165,221,386,False
2011-11-12,16,7577,137,224,361,False
2011-11-12,17,7578,92,193,285,False
2011-11-12,18,7579,53,150,203,False
2011-11-12,19,7580,32,139,171,False
2011-11-12,20,7581,31,101,132,False
2011-11-12,21,7582,19,103,122,False
2011-11-12,22,7583,30,88,118,False
2011-11-12,23,7584,23,78,101,False
2011-11-13,0,7585,12,61,73,False
2011-11-13,1,7586,13,58,71,False
2011-11-13,2,7587,9,48,57,False
2011-11-13,3,7588,8,20,28,False
2011-11-13,4,7589,1,5,6,False
2011-11-13,5,7590,2,3,5,False
2011-11-13,6,7591,5,18,23,False
2011-11-13,7,7592,13,30,43,False
2011-11-13,8,7593,24,55,79,False
2011-11-13,9,7594,38,97,135,False
2011-11-13,10,7595,63,178,241,False
2011-11-13,11,7596,108,187,295,False
2011-11-13,12,7597,112,242,354,False
2011-11-13,13,7598,105,234,339,False
2011-11-13,14,7599,108,263,371,False
2011-11-13,15,7600,89,221,310,False
2011-11-13,16,7601,93,226,319,False
2011-11-13,17,7602,44,187,231,False
2011-11-13,18,7603,35,155,190,False
2011-11-13,19,7604,36,121,157,False
2011-11-13,20,7605,24,115,139,False
2011-11-13,21,7606,19,76,95,False
2011-11-13,22,7607,25,64,89,False
2011-11-13,23,7608,18,49,67,False
2011-11-14,0,7609,8,22,30,False
2011-11-14,1,7610,5,6,11,False
2011-11-14,2,7611,7,10,17,False
2011-11-14,3,7612,4,3,7,False
2011-11-14,4,7613,0,5,5,False
2011-11-14,5,7614,0,19,19,False
2011-11-14,6,7615,10,104,114,False
2011-11-14,7,7616,11,311,322,False
2011-11-14,8,7617,27,425,452,False
2011-11-14,9,7618,29,204,233,False
2011-11-14,10,7619,26,85,111,False
2011-11-14,11,7620,22,106,128,False
2011-11-14,12,7621,36,166,202,False
2011-11-14,13,7622,50,153,203,False
2011-11-14,14,7623,47,138,185,False
2011-11-14,15,7624,53,142,195,False
2011-11-14,16,7625,51,264,315,False
2011-11-14,17,7626,55,464,519,False
2011-11-14,18,7627,29,460,489,False
2011-11-14,19,7628,28,274,302,False
2011-11-14,20,7629,30,210,240,False
2011-11-14,21,7630,37,176,213,False
2011-11-14,22,7631,17,96,113,False
2011-11-14,23,7632,13,48,61,False
2011-11-15,0,7633,7,15,22,False
2011-11-15,1,7634,5,5,10,False
2011-11-15,2,7635,7,8,15,False
2011-11-15,3,7636,0,4,4,False
2011-11-15,4,7637,1,6,7,False
2011-11-15,5,7638,2,26,28,False
2011-11-15,6,7639,4,104,108,False
2011-11-15,7,7640,21,298,319,False
2011-11-15,8,7641,27,453,480,False
2011-11-15,9,7642,26,174,200,False
2011-11-15,10,7643,23,115,138,False
2011-11-15,11,7644,18,116,134,False
2011-11-15,12,7645,28,148,176,False
2011-11-15,13,7646,21,132,153,False
2011-11-15,14,7647,27,120,147,False
2011-11-15,15,7648,36,155,191,False
2011-11-15,16,7649,31,240,271,False
2011-11-15,17,7650,29,422,451,False
2011-11-15,18,7651,27,414,441,False
2011-11-15,19,7652,27,259,286,False
2011-11-15,20,7653,26,212,238,False
2011-11-15,21,7654,23,145,168,False
2011-11-15,22,7655,19,109,128,False
2011-11-15,23,7656,14,66,80,False
2011-11-16,0,7657,5,26,31,False
2011-11-16,1,7658,0,5,5,False
2011-11-16,2,7659,4,6,10,False
2011-11-16,3,7660,2,3,5,False
2011-11-16,4,7661,1,3,4,False
2011-11-16,5,7662,0,13,13,False
2011-11-16,6,7663,4,52,56,False
2011-11-16,7,7664,7,130,137,False
2011-11-16,8,7665,9,223,232,False
2011-11-16,9,7666,5,77,82,False
2011-11-16,10,7667,4,32,36,False
2011-11-16,11,7668,7,53,60,False
2011-11-16,12,7669,5,49,54,False
2011-11-16,13,7670,6,52,58,False
2011-11-16,14,7671,12,49,61,False
2011-11-16,15,7672,16,50,66,False
2011-11-16,16,7673,13,110,123,False
2011-11-16,17,7674,17,216,233,False
2011-11-16,18,7675,13,176,189,False
2011-11-16,19,7676,3,108,111,False
2011-11-16,20,7677,5,94,99,False
2011-11-16,21,7678,3,72,75,False
2011-11-16,22,7679,1,45,46,False
2011-11-16,23,7680,3,28,31,False
2011-11-17,0,7681,2,22,24,False
2011-11-17,1,7682,0,5,5,False
2011-11-17,2,7683,0,5,5,False
2011-11-17,3,7684,0,3,3,False
2011-11-17,4,7685,1,3,4,False
2011-11-17,5,7686,1,21,22,False
2011-11-17,6,7687,3,72,75,False
2011-11-17,7,7688,4,164,168,False
2011-11-17,8,7689,12,343,355,False
2011-11-17,9,7690,14,184,198,False
2011-11-17,10,7691,7,74,81,False
2011-11-17,11,7692,4,93,97,False
2011-11-17,12,7693,6,115,121,False
2011-11-17,13,7694,15,109,124,False
2011-11-17,14,7695,5,105,110,False
2011-11-17,15,7696,10,106,116,False
2011-11-17,16,7697,8,187,195,False
2011-11-17,17,7698,20,379,399,False
2011-11-17,18,7699,9,298,307,False
2011-11-17,19,7700,7,210,217,False
2011-11-17,20,7701,7,162,169,False
2011-11-17,21,7702,3,113,116,False
2011-11-17,22,7703,1,83,84,False
2011-11-17,23,7704,0,58,58,False
2011-11-18,0,7705,2,28,30,False
2011-11-18,1,7706,0,10,10,False
2011-11-18,2,7707,2,8,10,False
2011-11-18,3,7708,0,2,2,False
2011-11-18,4,7709,0,5,5,False
2011-11-18,5,7710,0,22,22,False
2011-11-18,6,7711,1,70,71,False
2011-11-18,7,7712,5,211,216,False
2011-11-18,8,7713,6,369,375,False
2011-11-18,9,7714,6,207,213,False
2011-11-18,10,7715,10,105,115,False
2011-11-18,11,7716,18,122,140,False
2011-11-18,12,7717,22,143,165,False
2011-11-18,13,7718,31,146,177,False
2011-11-18,14,7719,31,123,154,False
2011-11-18,15,7720,27,151,178,False
2011-11-18,16,7721,19,190,209,False
2011-11-18,17,7722,17,361,378,False
2011-11-18,18,7723,16,312,328,False
2011-11-18,19,7724,7,183,190,False
2011-11-18,20,7725,8,129,137,False
2011-11-18,21,7726,3,108,111,False
2011-11-18,22,7727,9,88,97,False
2011-11-18,23,7728,5,54,59,False
2011-11-19,0,7729,4,49,53,False
2011-11-19,1,7730,1,34,35,False
2011-11-19,2,7731,12,34,46,False
2011-11-19,3,7732,4,11,15,False
2011-11-19,4,7733,4,4,8,False
2011-11-19,5,7734,0,2,2,False
2011-11-19,6,7735,2,10,12,False
2011-11-19,7,7736,3,38,41,False
2011-11-19,8,7737,12,80,92,False
2011-11-19,9,7738,12,130,142,False
2011-11-19,10,7739,35,165,200,False
2011-11-19,11,7740,50,183,233,False
2011-11-19,12,7741,93,218,311,False
2011-11-19,13,7742,118,245,363,False
2011-11-19,14,7743,121,228,349,False
2011-11-19,15,7744,120,262,382,False
2011-11-19,16,7745,99,188,287,False
2011-11-19,17,7746,61,171,232,False
2011-11-19,18,7747,36,172,208,False
2011-11-19,19,7748,33,149,182,False
2011-11-19,20,7749,48,115,163,False
2011-11-19,21,7750,29,79,108,False
2011-11-19,22,7751,26,80,106,False
2011-11-19,23,7752,20,73,93,False
2011-11-20,0,7753,14,79,93,False
2011-11-20,1,7754,11,73,84,False
2011-11-20,2,7755,12,44,56,False
2011-11-20,3,7756,6,31,37,False
2011-11-20,4,7757,2,10,12,False
2011-11-20,5,7758,0,4,4,False
2011-11-20,6,7759,3,6,9,False
2011-11-20,7,7760,4,19,23,False
2011-11-20,8,7761,13,52,65,False
2011-11-20,9,7762,29,109,138,False
2011-11-20,10,7763,46,183,229,False
2011-11-20,11,7764,74,212,286,False
2011-11-20,12,7765,70,234,304,False
2011-11-20,13,7766,84,285,369,False
2011-11-20,14,7767,113,250,363,False
2011-11-20,15,7768,109,242,351,False
2011-11-20,16,7769,81,225,306,False
2011-11-20,17,7770,35,168,203,False
2011-11-20,18,7771,22,123,145,False
2011-11-20,19,7772,17,140,157,False
2011-11-20,20,7773,23,90,113,False
2011-11-20,21,7774,11,94,105,False
2011-11-20,22,7775,5,35,40,False
2011-11-20,23,7776,3,25,28,False
2011-11-21,0,7777,4,13,17,False
2011-11-21,1,7778,4,8,12,False
2011-11-21,2,7779,1,2,3,False
2011-11-21,3,7780,0,4,4,False
2011-11-21,4,7781,0,5,5,False
2011-11-21,5,7782,0,20,20,False
2011-11-21,6,7783,0,76,76,False
2011-11-21,7,7784,17,229,246,False
2011-11-21,8,7785,13,378,391,False
2011-11-21,9,7786,15,222,237,False
2011-11-21,10,7787,25,110,135,False
2011-11-21,11,7788,16,112,128,False
2011-11-21,12,7789,24,138,162,False
2011-11-21,13,7790,13,121,134,False
2011-11-21,14,7791,14,121,135,False
2011-11-21,15,7792,15,93,108,False
2011-11-21,16,7793,13,95,108,False
2011-11-21,17,7794,10,200,210,False
2011-11-21,18,7795,8,184,192,False
2011-11-21,19,7796,2,135,137,False
2011-11-21,20,7797,5,75,80,False
2011-11-21,21,7798,11,103,114,False
2011-11-21,22,7799,6,72,78,False
2011-11-21,23,7800,4,29,33,False
2011-11-22,0,7801,0,14,14,False
2011-11-22,1,7802,1,5,6,False
2011-11-22,2,7803,2,4,6,False
2011-11-22,3,7804,1,2,3,False
2011-11-22,4,7805,0,7,7,False
2011-11-22,5,7806,1,17,18,False
2011-11-22,6,7807,1,63,64,False
2011-11-22,7,7808,2,119,121,False
2011-11-22,8,7809,5,185,190,False
2011-11-22,9,7810,2,147,149,False
2011-11-22,10,7811,6,46,52,False
2011-11-22,11,7812,4,28,32,False
2011-11-22,12,7813,3,18,21,False
2011-11-22,13,7814,4,22,26,False
2011-11-22,14,7815,4,31,35,False
2011-11-22,15,7816,2,32,34,False
2011-11-22,16,7817,3,59,62,False
2011-11-22,17,7818,4,161,165,False
2011-11-22,18,7819,0,148,148,False
2011-11-22,19,7820,5,106,111,False
2011-11-22,20,7821,6,121,127,False
2011-11-22,21,7822,4,86,90,False
2011-11-22,22,7823,6,81,87,False
2011-11-22,23,7824,3,36,39,False
2011-11-23,0,7825,2,14,16,False
2011-11-23,1,7826,0,8,8,False
2011-11-23,2,7827,1,5,6,False
2011-11-23,3,7828,1,2,3,False
2011-11-23,4,7829,0,5,5,False
2011-11-23,5,7830,1,16,17,False
2011-11-23,6,7831,1,68,69,False
2011-11-23,7,7832,2,154,156,False
2011-11-23,8,7833,7,316,323,False
2011-11-23,9,7834,3,164,167,False
2011-11-23,10,7835,6,70,76,False
2011-11-23,11,7836,9,107,116,False
2011-11-23,12,7837,9,151,160,False
2011-11-23,13,7838,12,162,174,False
2011-11-23,14,7839,13,200,213,False
2011-11-23,15,7840,13,194,207,False
2011-11-23,16,7841,4,169,173,False
2011-11-23,17,7842,7,156,163,False
2011-11-23,18,7843,7,138,145,False
2011-11-23,19,7844,6,116,122,False
2011-11-23,20,7845,1,67,68,False
2011-11-23,21,7846,0,66,66,False
2011-11-23,22,7847,3,59,62,False
2011-11-23,23,7848,4,47,51,False
2011-11-24,0,7849,1,22,23,False
2011-11-24,1,7850,1,23,24,False
2011-11-24,2,7851,3,19,22,False
2011-11-24,3,7852,1,4,5,False
2011-11-24,4,7853,1,1,2,False
2011-11-24,5,7854,1,10,11,False
2011-11-24,6,7855,1,5,6,False
2011-11-24,7,7856,9,31,40,False
2011-11-24,8,7857,4,42,46,False
2011-11-24,9,7858,13,68,81,False
2011-11-24,10,7859,34,64,98,False
2011-11-24,11,7860,52,90,142,False
2011-11-24,12,7861,62,88,150,False
2011-11-24,13,7862,84,91,175,False
2011-11-24,14,7863,74,94,168,False
2011-11-24,15,7864,78,71,149,False
2011-11-24,16,7865,48,66,114,False
2011-11-24,17,7866,34,40,74,False
2011-11-24,18,7867,13,24,37,False
2011-11-24,19,7868,15,13,28,False
2011-11-24,20,7869,14,17,31,False
2011-11-24,21,7870,7,19,26,False
2011-11-24,22,7871,8,14,22,False
2011-11-24,23,7872,2,19,21,False
2011-11-25,0,7873,7,22,29,False
2011-11-25,1,7874,2,12,14,False
2011-11-25,2,7875,4,6,10,False
2011-11-25,3,7876,0,2,2,False
2011-11-25,4,7877,4,3,7,False
2011-11-25,5,7878,2,3,5,False
2011-11-25,6,7879,4,9,13,False
2011-11-25,7,7880,4,31,35,False
2011-11-25,8,7881,6,68,74,False
2011-11-25,9,7882,25,70,95,False
2011-11-25,10,7883,60,82,142,False
2011-11-25,11,7884,99,127,226,False
2011-11-25,12,7885,126,146,272,False
2011-11-25,13,7886,143,140,283,False
2011-11-25,14,7887,122,150,272,False
2011-11-25,15,7888,165,145,310,False
2011-11-25,16,7889,122,139,261,False
2011-11-25,17,7890,57,127,184,False
2011-11-25,18,7891,45,108,153,False
2011-11-25,19,7892,38,96,134,False
2011-11-25,20,7893,19,76,95,False
2011-11-25,21,7894,24,61,85,False
2011-11-25,22,7895,12,46,58,False
2011-11-25,23,7896,5,28,33,False
2011-11-26,0,7897,9,38,47,False
2011-11-26,1,7898,5,24,29,False
2011-11-26,2,7899,3,20,23,False
2011-11-26,3,7900,8,9,17,False
2011-11-26,4,7901,0,4,4,False
2011-11-26,5,7902,0,3,3,False
2011-11-26,6,7903,2,8,10,False
2011-11-26,7,7904,4,13,17,False
2011-11-26,8,7905,10,50,60,False
2011-11-26,9,7906,16,67,83,False
2011-11-26,10,7907,57,84,141,False
2011-11-26,11,7908,107,123,230,False
2011-11-26,12,7909,137,172,309,False
2011-11-26,13,7910,177,148,325,False
2011-11-26,14,7911,141,158,299,False
2011-11-26,15,7912,154,160,314,False
2011-11-26,16,7913,137,138,275,False
2011-11-26,17,7914,62,122,184,False
2011-11-26,18,7915,67,118,185,False
2011-11-26,19,7916,46,100,146,False
2011-11-26,20,7917,55,86,141,False
2011-11-26,21,7918,20,72,92,False
2011-11-26,22,7919,14,51,65,False
2011-11-26,23,7920,18,51,69,False
2011-11-27,0,7921,7,39,46,False
2011-11-27,1,7922,9,35,44,False
2011-11-27,2,7923,9,22,31,False
2011-11-27,3,7924,9,8,17,False
2011-11-27,4,7925,0,4,4,False
2011-11-27,5,7926,0,5,5,False
2011-11-27,6,7927,0,9,9,False
2011-11-27,7,7928,12,11,23,False
2011-11-27,8,7929,6,36,42,False
2011-11-27,9,7930,21,90,111,False
2011-11-27,10,7931,58,131,189,False
2011-11-27,11,7932,83,157,240,False
2011-11-27,12,7933,63,193,256,False
2011-11-27,13,7934,97,216,313,False
2011-11-27,14,7935,113,200,313,False
2011-11-27,15,7936,96,221,317,False
2011-11-27,16,7937,94,229,323,False
2011-11-27,17,7938,37,167,204,False
2011-11-27,18,7939,25,130,155,False
2011-11-27,19,7940,30,109,139,False
2011-11-27,20,7941,10,94,104,False
2011-11-27,21,7942,13,75,88,False
2011-11-27,22,7943,13,53,66,False
2011-11-27,23,7944,5,27,32,False
2011-11-28,0,7945,6,10,16,False
2011-11-28,1,7946,1,12,13,False
2011-11-28,2,7947,5,18,23,True
2011-11-28,3,7948,1,4,5,False
2011-11-28,4,7949,0,4,4,False
2011-11-28,5,7950,0,34,34,False
2011-11-28,6,7951,6,98,104,False
2011-11-28,7,7952,7,270,277,False
2011-11-28,8,7953,13,394,407,False
2011-11-28,9,7954,17,191,208,False
2011-11-28,10,7955,21,86,107,False
2011-11-28,11,7956,11,107,118,False
2011-11-28,12,7957,13,165,178,False
2011-11-28,13,7958,25,137,162,False
2011-11-28,14,7959,14,129,143,False
2011-11-28,15,7960,18,132,150,False
2011-11-28,16,7961,24,240,264,False
2011-11-28,17,7962,24,444,468,False
2011-11-28,18,7963,20,396,416,False
2011-11-28,19,7964,4,260,264,False
2011-11-28,20,7965,12,206,218,False
2011-11-28,21,7966,4,152,156,False
2011-11-28,22,7967,7,102,109,False
2011-11-28,23,7968,5,41,46,False
2011-11-29,0,7969,4,18,22,False
2011-11-29,1,7970,1,16,17,False
2011-11-29,2,7971,0,5,5,False
2011-11-29,3,7972,0,2,2,False
2011-11-29,4,7973,1,5,6,False
2011-11-29,5,7974,1,21,22,False
2011-11-29,6,7975,1,88,89,False
2011-11-29,7,7976,12,330,342,False
2011-11-29,8,7977,9,440,449,False
2011-11-29,9,7978,5,197,202,False
2011-11-29,10,7979,2,34,36,False
2011-11-29,11,7980,1,10,11,False
2011-11-29,12,7981,1,17,18,False
2011-11-29,13,7982,0,22,22,False
2011-11-29,14,7983,1,35,36,False
2011-11-29,15,7984,5,60,65,False
2011-11-29,16,7985,5,146,151,False
2011-11-29,17,7986,8,346,354,False
2011-11-29,18,7987,11,347,358,False
2011-11-29,19,7988,6,244,250,False
2011-11-29,20,7989,8,176,184,False
2011-11-29,21,7990,9,116,125,False
2011-11-29,22,7991,5,90,95,False
2011-11-29,23,7992,0,53,53,False
2011-11-30,0,7993,1,23,24,False
2011-11-30,1,7994,0,8,8,False
2011-11-30,2,7995,0,5,5,False
2011-11-30,3,7996,0,1,1,False
2011-11-30,4,7997,0,5,5,False
2011-11-30,5,7998,1,21,22,False
2011-11-30,6,7999,3,100,103,False
2011-11-30,7,8000,9,276,285,False
2011-11-30,8,8001,13,465,478,False
2011-11-30,9,8002,7,186,193,False
2011-11-30,10,8003,15,95,110,False
2011-11-30,11,8004,10,112,122,False
2011-11-30,12,8005,12,148,160,False
2011-11-30,13,8006,16,131,147,False
2011-11-30,14,8007,13,99,112,False
2011-11-30,15,8008,11,104,115,False
2011-11-30,16,8009,27,199,226,False
2011-11-30,17,8010,15,365,380,False
2011-11-30,18,8011,7,369,376,False
2011-11-30,19,8012,6,273,279,False
2011-11-30,20,8013,6,184,190,False
2011-11-30,21,8014,7,128,135,False
2011-11-30,22,8015,5,82,87,False
2011-11-30,23,8016,4,46,50,False
2011-12-01,0,8017,1,19,20,False
2011-12-01,1,8018,1,9,10,False
2011-12-01,2,8019,1,8,9,False
2011-12-01,3,8020,1,6,7,False
2011-12-01,4,8021,0,1,1,False
2011-12-01,5,8022,1,23,24,False
2011-12-01,6,8023,5,92,97,False
2011-12-01,7,8024,11,265,276,False
2011-12-01,8,8025,15,462,477,False
2011-12-01,9,8026,9,215,224,False
2011-12-01,10,8027,7,86,93,False
2011-12-01,11,8028,7,95,102,False
2011-12-01,12,8029,9,139,148,False
2011-12-01,13,8030,17,137,154,False
2011-12-01,14,8031,20,130,150,False
2011-12-01,15,8032,10,144,154,False
2011-12-01,16,8033,9,192,201,False
2011-12-01,17,8034,9,409,418,False
2011-12-01,18,8035,12,393,405,False
2011-12-01,19,8036,9,219,228,False
2011-12-01,20,8037,12,178,190,False
2011-12-01,21,8038,8,154,162,False
2011-12-01,22,8039,5,99,104,False
2011-12-01,23,8040,3,70,73,False
2011-12-02,0,8041,6,32,38,False
2011-12-02,1,8042,1,14,15,False
2011-12-02,2,8043,0,10,10,False
2011-12-02,3,8044,0,1,1,False
2011-12-02,4,8045,0,3,3,False
2011-12-02,5,8046,0,23,23,False
2011-12-02,6,8047,3,84,87,False
2011-12-02,7,8048,6,199,205,False
2011-12-02,8,8049,13,432,445,False
2011-12-02,9,8050,12,234,246,False
2011-12-02,10,8051,16,89,105,False
2011-12-02,11,8052,18,142,160,False
2011-12-02,12,8053,18,186,204,False
2011-12-02,13,8054,19,188,207,False
2011-12-02,14,8055,25,145,170,False
2011-12-02,15,8056,24,175,199,False
2011-12-02,16,8057,22,254,276,False
2011-12-02,17,8058,20,391,411,False
2011-12-02,18,8059,10,362,372,False
2011-12-02,19,8060,13,252,265,False
2011-12-02,20,8061,12,178,190,False
2011-12-02,21,8062,9,102,111,False
2011-12-02,22,8063,7,95,102,False
2011-12-02,23,8064,14,81,95,False
2011-12-03,0,8065,10,65,75,False
2011-12-03,1,8066,9,62,71,False
2011-12-03,2,8067,9,41,50,False
2011-12-03,3,8068,4,5,9,False
2011-12-03,4,8069,1,7,8,False
2011-12-03,5,8070,0,6,6,False
2011-12-03,6,8071,1,10,11,False
2011-12-03,7,8072,2,24,26,False
2011-12-03,8,8073,1,62,63,False
2011-12-03,9,8074,25,99,124,False
2011-12-03,10,8075,22,173,195,False
2011-12-03,11,8076,48,227,275,False
2011-12-03,12,8077,78,280,358,False
2011-12-03,13,8078,70,222,292,False
2011-12-03,14,8079,92,251,343,False
2011-12-03,15,8080,100,237,337,False
2011-12-03,16,8081,75,230,305,False
2011-12-03,17,8082,46,186,232,False
2011-12-03,18,8083,31,193,224,False
2011-12-03,19,8084,31,144,175,False
2011-12-03,20,8085,17,110,127,False
2011-12-03,21,8086,5,104,109,False
2011-12-03,22,8087,17,97,114,False
2011-12-03,23,8088,12,73,85,False
2011-12-04,0,8089,19,64,83,False
2011-12-04,1,8090,20,54,74,False
2011-12-04,2,8091,11,51,62,False
2011-12-04,3,8092,7,34,41,False
2011-12-04,4,8093,2,9,11,False
2011-12-04,5,8094,2,2,4,False
2011-12-04,6,8095,1,3,4,False
2011-12-04,7,8096,3,23,26,False
2011-12-04,8,8097,7,48,55,False
2011-12-04,9,8098,12,114,126,False
2011-12-04,10,8099,36,180,216,False
2011-12-04,11,8100,48,206,254,False
2011-12-04,12,8101,82,247,329,False
2011-12-04,13,8102,88,269,357,False
2011-12-04,14,8103,77,246,323,False
2011-12-04,15,8104,69,227,296,False
2011-12-04,16,8105,64,266,330,False
2011-12-04,17,8106,38,207,245,False
2011-12-04,18,8107,10,161,171,False
2011-12-04,19,8108,15,158,173,False
2011-12-04,20,8109,8,116,124,False
2011-12-04,21,8110,7,65,72,False
2011-12-04,22,8111,5,59,64,False
2011-12-04,23,8112,3,42,45,False
2011-12-05,0,8113,3,21,24,False
2011-12-05,1,8114,2,10,12,False
2011-12-05,2,8115,0,8,8,False
2011-12-05,3,8116,0,2,2,False
2011-12-05,4,8117,0,7,7,False
2011-12-05,5,8118,1,24,25,False
2011-12-05,6,8119,1,89,90,False
2011-12-05,7,8120,9,274,283,False
2011-12-05,8,8121,12,392,404,False
2011-12-05,9,8122,12,178,190,False
2011-12-05,10,8123,9,78,87,False
2011-12-05,11,8124,17,106,123,False
2011-12-05,12,8125,29,125,154,False
2011-12-05,13,8126,18,153,171,False
2011-12-05,14,8127,7,126,133,False
2011-12-05,15,8128,16,132,148,False
2011-12-05,16,8129,10,238,248,False
2011-12-05,17,8130,16,430,446,False
2011-12-05,18,8131,13,386,399,False
2011-12-05,19,8132,13,295,308,False
2011-12-05,20,8133,15,190,205,False
2011-12-05,21,8134,10,166,176,False
2011-12-05,22,8135,12,94,106,False
2011-12-05,23,8136,8,54,62,False
2011-12-06,0,8137,3,25,28,False
2011-12-06,1,8138,2,14,16,False
2011-12-06,2,8139,0,3,3,False
2011-12-06,3,8140,0,3,3,False
2011-12-06,4,8141,0,7,7,False
2011-12-06,5,8142,0,20,20,False
2011-12-06,6,8143,5,81,86,False
2011-12-06,7,8144,7,227,234,False
2011-12-06,8,8145,13,401,414,False
2011-12-06,9,8146,4,200,204,False
2011-12-06,10,8147,6,44,50,False
2011-12-06,11,8148,4,28,32,False
2011-12-06,12,8149,5,50,55,False
2011-12-06,13,8150,6,65,71,False
2011-12-06,14,8151,6,69,75,False
2011-12-06,15,8152,2,43,45,False
2011-12-06,16,8153,4,84,88,False
2011-12-06,17,8154,13,249,262,False
2011-12-06,18,8155,17,287,304,False
2011-12-06,19,8156,10,223,233,False
2011-12-06,20,8157,3,107,110,False
2011-12-06,21,8158,6,108,114,False
2011-12-06,22,8159,5,82,87,False
2011-12-06,23,8160,5,48,53,False
2011-12-07,0,8161,3,30,33,False
2011-12-07,1,8162,4,9,13,False
2011-12-07,2,8163,2,4,6,False
2011-12-07,3,8164,0,3,3,False
2011-12-07,4,8165,0,1,1,False
2011-12-07,5,8166,0,3,3,False
2011-12-07,6,8167,0,18,18,False
2011-12-07,7,8168,3,43,46,False
2011-12-07,8,8169,6,80,86,False
2011-12-07,9,8170,0,64,64,False
2011-12-07,10,8171,1,32,33,False
2011-12-07,11,8172,3,47,50,False
2011-12-07,12,8173,4,29,33,False
2011-12-07,13,8174,5,28,33,False
2011-12-07,14,8175,1,24,25,False
2011-12-07,15,8176,5,25,30,False
2011-12-07,16,8177,3,28,31,False
2011-12-07,17,8178,4,48,52,False
2011-12-07,18,8179,3,48,51,False
2011-12-07,19,8180,2,31,33,False
2011-12-07,20,8181,1,25,26,False
2011-12-07,21,8182,0,6,6,False
2011-12-07,22,8183,0,13,13,False
2011-12-07,23,8184,0,16,16,False
2011-12-08,0,8185,0,21,21,False
2011-12-08,1,8186,1,6,7,False
2011-12-08,2,8187,0,4,4,False
2011-12-08,3,8188,0,1,1,False
2011-12-08,4,8189,0,2,2,False
2011-12-08,5,8190,0,12,12,False
2011-12-08,6,8191,0,71,71,False
2011-12-08,7,8192,11,233,244,False
2011-12-08,8,8193,11,418,429,False
2011-12-08,9,8194,7,218,225,False
2011-12-08,10,8195,1,109,110,False
2011-12-08,11,8196,6,100,106,False
2011-12-08,12,8197,8,148,156,False
2011-12-08,13,8198,9,115,124,False
2011-12-08,14,8199,16,121,137,False
2011-12-08,15,8200,19,98,117,False
2011-12-08,16,8201,7,201,208,False
2011-12-08,17,8202,10,321,331,False
2011-12-08,18,8203,12,306,318,False
2011-12-08,19,8204,12,220,232,False
2011-12-08,20,8205,5,170,175,False
2011-12-08,21,8206,4,135,139,False
2011-12-08,22,8207,8,84,92,False
2011-12-08,23,8208,3,58,61,False
2011-12-09,0,8209,8,26,34,False
2011-12-09,1,8210,2,12,14,False
2011-12-09,2,8211,2,10,12,False
2011-12-09,3,8212,1,5,6,False
2011-12-09,4,8213,1,1,2,False
2011-12-09,5,8214,0,20,20,False
2011-12-09,6,8215,1,62,63,False
2011-12-09,7,8216,4,195,199,False
2011-12-09,8,8217,7,378,385,False
2011-12-09,9,8218,8,256,264,False
2011-12-09,10,8219,11,115,126,False
2011-12-09,11,8220,15,121,136,False
2011-12-09,12,8221,27,146,173,False
2011-12-09,13,8222,27,141,168,False
2011-12-09,14,8223,24,163,187,False
2011-12-09,15,8224,29,160,189,False
2011-12-09,16,8225,24,226,250,False
2011-12-09,17,8226,10,352,362,False
2011-12-09,18,8227,10,308,318,False
2011-12-09,19,8228,10,189,199,False
2011-12-09,20,8229,10,140,150,False
2011-12-09,21,8230,9,131,140,False
2011-12-09,22,8231,15,114,129,False
2011-12-09,23,8232,6,88,94,False
2011-12-10,0,8233,11,66,77,False
2011-12-10,1,8234,11,55,66,False
2011-12-10,2,8235,12,48,60,False
2011-12-10,3,8236,5,20,25,False
2011-12-10,4,8237,0,3,3,False
2011-12-10,5,8238,0,6,6,False
2011-12-10,6,8239,1,10,11,False
2011-12-10,7,8240,0,11,11,False
2011-12-10,8,8241,5,68,73,False
2011-12-10,9,8242,15,134,149,False
2011-12-10,10,8243,31,161,192,False
2011-12-10,11,8244,44,192,236,False
2011-12-10,12,8245,48,235,283,False
2011-12-10,13,8246,47,239,286,False
2011-12-10,14,8247,51,242,293,False
2011-12-10,15,8248,60,239,299,False
2011-12-10,16,8249,58,183,241,False
2011-12-10,17,8250,34,151,185,False
2011-12-10,18,8251,28,144,172,False
2011-12-10,19,8252,15,139,154,False
2011-12-10,20,8253,10,114,124,False
2011-12-10,21,8254,4,79,83,False
2011-12-10,22,8255,7,88,95,False
2011-12-10,23,8256,5,61,66,False
2011-12-11,0,8257,5,69,74,False
2011-12-11,1,8258,8,54,62,False
2011-12-11,2,8259,5,47,52,False
2011-12-11,3,8260,2,17,19,False
2011-12-11,4,8261,0,5,5,False
2011-12-11,5,8262,0,6,6,False
2011-12-11,6,8263,0,10,10,False
2011-12-11,7,8264,1,30,31,False
2011-12-11,8,8265,4,68,72,False
2011-12-11,9,8266,19,88,107,False
2011-12-11,10,8267,30,164,194,False
2011-12-11,11,8268,31,166,197,False
2011-12-11,12,8269,42,246,288,False
2011-12-11,13,8270,44,224,268,False
2011-12-11,14,8271,44,198,242,False
2011-12-11,15,8272,47,219,266,False
2011-12-11,16,8273,32,174,206,False
2011-12-11,17,8274,13,150,163,False
2011-12-11,18,8275,12,151,163,False
2011-12-11,19,8276,7,98,105,False
2011-12-11,20,8277,10,62,72,False
2011-12-11,21,8278,10,53,63,False
2011-12-11,22,8279,7,36,43,False
2011-12-11,23,8280,4,31,35,False
2011-12-12,0,8281,4,16,20,False
2011-12-12,1,8282,0,9,9,False
2011-12-12,2,8283,0,4,4,False
2011-12-12,3,8284,0,2,2,False
2011-12-12,4,8285,0,3,3,False
2011-12-12,5,8286,0,21,21,False
2011-12-12,6,8287,1,63,64,False
2011-12-12,7,8288,4,231,235,False
2011-12-12,8,8289,7,378,385,False
2011-12-12,9,8290,12,208,220,False
2011-12-12,10,8291,14,91,105,False
2011-12-12,11,8292,15,100,115,False
2011-12-12,12,8293,7,138,145,False
2011-12-12,13,8294,13,153,166,False
2011-12-12,14,8295,16,95,111,False
2011-12-12,15,8296,8,124,132,False
2011-12-12,16,8297,5,209,214,False
2011-12-12,17,8298,7,352,359,False
2011-12-12,18,8299,8,349,357,False
2011-12-12,19,8300,9,232,241,False
2011-12-12,20,8301,8,157,165,False
2011-12-12,21,8302,2,119,121,False
2011-12-12,22,8303,0,71,71,False
2011-12-12,23,8304,3,42,45,False
2011-12-13,0,8305,1,16,17,False
2011-12-13,1,8306,0,4,4,False
2011-12-13,2,8307,1,1,2,False
2011-12-13,3,8308,0,3,3,False
2011-12-13,4,8309,0,4,4,False
2011-12-13,5,8310,0,20,20,False
2011-12-13,6,8311,0,92,92,False
2011-12-13,7,8312,2,221,223,False
2011-12-13,8,8313,9,391,400,False
2011-12-13,9,8314,10,223,233,False
2011-12-13,10,8315,3,99,102,False
2011-12-13,11,8316,9,115,124,False
2011-12-13,12,8317,20,147,167,False
2011-12-13,13,8318,7,120,127,False
2011-12-13,14,8319,18,116,134,False
2011-12-13,15,8320,7,144,151,False
2011-12-13,16,8321,13,194,207,False
2011-12-13,17,8322,17,381,398,False
2011-12-13,18,8323,12,370,382,False
2011-12-13,19,8324,5,262,267,False
2011-12-13,20,8325,7,154,161,False
2011-12-13,21,8326,5,134,139,False
2011-12-13,22,8327,5,102,107,False
2011-12-13,23,8328,4,55,59,False
2011-12-14,0,8329,0,22,22,False
2011-12-14,1,8330,0,8,8,False
2011-12-14,2,8331,0,2,2,False
2011-12-14,3,8332,0,3,3,False
2011-12-14,4,8333,0,4,4,False
2011-12-14,5,8334,0,26,26,False
2011-12-14,6,8335,0,87,87,False
2011-12-14,7,8336,4,243,247,False
2011-12-14,8,8337,9,458,467,False
2011-12-14,9,8338,9,230,239,False
2011-12-14,10,8339,9,133,142,False
2011-12-14,11,8340,12,103,115,False
2011-12-14,12,8341,6,138,144,False
2011-12-14,13,8342,14,119,133,False
2011-12-14,14,8343,17,134,151,False
2011-12-14,15,8344,24,143,167,False
2011-12-14,16,8345,12,233,245,False
2011-12-14,17,8346,19,377,396,False
2011-12-14,18,8347,11,379,390,False
2011-12-14,19,8348,9,259,268,False
2011-12-14,20,8349,6,169,175,False
2011-12-14,21,8350,9,145,154,False
2011-12-14,22,8351,5,99,104,False
2011-12-14,23,8352,3,48,51,False
2011-12-15,0,8353,5,45,50,False
2011-12-15,1,8354,5,15,20,False
2011-12-15,2,8355,2,5,7,False
2011-12-15,3,8356,1,2,3,False
2011-12-15,4,8357,0,6,6,False
2011-12-15,5,8358,0,24,24,False
2011-12-15,6,8359,2,90,92,False
2011-12-15,7,8360,6,252,258,False
2011-12-15,8,8361,8,449,457,False
2011-12-15,9,8362,6,274,280,False
2011-12-15,10,8363,4,105,109,False
2011-12-15,11,8364,9,126,135,False
2011-12-15,12,8365,17,140,157,False
2011-12-15,13,8366,14,150,164,False
2011-12-15,14,8367,8,124,132,False
2011-12-15,15,8368,6,76,82,False
2011-12-15,16,8369,7,124,131,False
2011-12-15,17,8370,14,310,324,False
2011-12-15,18,8371,14,363,377,False
2011-12-15,19,8372,13,274,287,False
2011-12-15,20,8373,12,209,221,False
2011-12-15,21,8374,10,145,155,False
2011-12-15,22,8375,8,116,124,False
2011-12-15,23,8376,10,104,114,False
2011-12-16,0,8377,12,60,72,False
2011-12-16,1,8378,3,28,31,False
2011-12-16,2,8379,0,23,23,False
2011-12-16,3,8380,2,3,5,False
2011-12-16,4,8381,1,4,5,False
2011-12-16,5,8382,0,26,26,False
2011-12-16,6,8383,2,80,82,False
2011-12-16,7,8384,5,226,231,False
2011-12-16,8,8385,10,449,459,False
2011-12-16,9,8386,8,235,243,False
2011-12-16,10,8387,10,122,132,False
2011-12-16,11,8388,9,135,144,False
2011-12-16,12,8389,10,163,173,False
2011-12-16,13,8390,12,125,137,False
2011-12-16,14,8391,13,115,128,False
2011-12-16,15,8392,12,141,153,False
2011-12-16,16,8393,12,212,224,False
2011-12-16,17,8394,13,352,365,False
2011-12-16,18,8395,10,285,295,False
2011-12-16,19,8396,11,203,214,False
2011-12-16,20,8397,6,146,152,False
2011-12-16,21,8398,7,95,102,False
2011-12-16,22,8399,6,100,106,False
2011-12-16,23,8400,4,71,75,False
2011-12-17,0,8401,3,59,62,False
2011-12-17,1,8402,4,39,43,False
2011-12-17,2,8403,11,47,58,False
2011-12-17,3,8404,4,22,26,False
2011-12-17,4,8405,0,9,9,False
2011-12-17,5,8406,2,7,9,False
2011-12-17,6,8407,0,17,17,False
2011-12-17,7,8408,0,20,20,False
2011-12-17,8,8409,4,55,59,False
2011-12-17,9,8410,5,95,100,False
2011-12-17,10,8411,10,171,181,False
2011-12-17,11,8412,21,188,209,False
2011-12-17,12,8413,28,216,244,False
2011-12-17,13,8414,32,204,236,False
2011-12-17,14,8415,30,207,237,False
2011-12-17,15,8416,33,195,228,False
2011-12-17,16,8417,30,192,222,False
2011-12-17,17,8418,12,153,165,False
2011-12-17,18,8419,7,150,157,False
2011-12-17,19,8420,11,95,106,False
2011-12-17,20,8421,7,99,106,False
2011-12-17,21,8422,8,88,96,False
2011-12-17,22,8423,7,73,80,False
2011-12-17,23,8424,6,63,69,False
2011-12-18,0,8425,7,64,71,False
2011-12-18,1,8426,3,43,46,False
2011-12-18,2,8427,2,39,41,False
2011-12-18,3,8428,2,16,18,False
2011-12-18,4,8429,0,1,1,False
2011-12-18,5,8430,1,4,5,False
2011-12-18,6,8431,0,3,3,False
2011-12-18,7,8432,1,11,12,False
2011-12-18,8,8433,1,31,32,False
2011-12-18,9,8434,6,75,81,False
2011-12-18,10,8435,7,122,129,False
2011-12-18,11,8436,20,168,188,False
2011-12-18,12,8437,26,202,228,False
2011-12-18,13,8438,18,210,228,False
2011-12-18,14,8439,19,200,219,False
2011-12-18,15,8440,23,184,207,False
2011-12-18,16,8441,27,207,234,False
2011-12-18,17,8442,10,126,136,False
2011-12-18,18,8443,15,123,138,False
2011-12-18,19,8444,5,130,135,False
2011-12-18,20,8445,10,94,104,False
2011-12-18,21,8446,9,80,89,False
2011-12-18,22,8447,2,47,49,False
2011-12-18,23,8448,6,31,37,False
2011-12-19,0,8449,3,14,17,False
2011-12-19,1,8450,3,8,11,False
2011-12-19,2,8451,0,3,3,False
2011-12-19,3,8452,0,3,3,False
2011-12-19,4,8453,0,4,4,False
2011-12-19,5,8454,0,21,21,False
2011-12-19,6,8455,0,68,68,False
2011-12-19,7,8456,4,187,191,False
2011-12-19,8,8457,8,389,397,False
2011-12-19,9,8458,17,166,183,False
2011-12-19,10,8459,12,96,108,False
2011-12-19,11,8460,22,105,127,False
2011-12-19,12,8461,13,128,141,False
2011-12-19,13,8462,15,127,142,False
2011-12-19,14,8463,30,107,137,False
2011-12-19,15,8464,24,135,159,False
2011-12-19,16,8465,19,189,208,False
2011-12-19,17,8466,16,362,378,False
2011-12-19,18,8467,11,343,354,False
2011-12-19,19,8468,17,234,251,False
2011-12-19,20,8469,9,197,206,False
2011-12-19,21,8470,15,112,127,False
2011-12-19,22,8471,12,95,107,False
2011-12-19,23,8472,10,50,60,False
2011-12-20,0,8473,0,21,21,False
2011-12-20,1,8474,0,6,6,False
2011-12-20,2,8475,1,10,11,False
2011-12-20,3,8476,1,1,2,False
2011-12-20,4,8477,0,4,4,False
2011-12-20,5,8478,0,15,15,False
2011-12-20,6,8479,1,71,72,False
2011-12-20,7,8480,7,261,268,False
2011-12-20,8,8481,10,422,432,False
2011-12-20,9,8482,14,245,259,False
2011-12-20,10,8483,20,109,129,False
2011-12-20,11,8484,13,116,129,False
2011-12-20,12,8485,16,159,175,False
2011-12-20,13,8486,18,163,181,False
2011-12-20,14,8487,11,127,138,False
2011-12-20,15,8488,15,139,154,False
2011-12-20,16,8489,20,218,238,False
2011-12-20,17,8490,14,417,431,False
2011-12-20,18,8491,26,385,411,False
2011-12-20,19,8492,6,218,224,False
2011-12-20,20,8493,3,144,147,False
2011-12-20,21,8494,4,139,143,False
2011-12-20,22,8495,3,104,107,False
2011-12-20,23,8496,13,40,53,False
2011-12-21,0,8497,7,18,25,False
2011-12-21,1,8498,1,10,11,False
2011-12-21,2,8499,0,4,4,False
2011-12-21,3,8500,0,2,2,False
2011-12-21,4,8501,0,2,2,False
2011-12-21,5,8502,0,28,28,False
2011-12-21,6,8503,1,75,76,False
2011-12-21,7,8504,5,224,229,False
2011-12-21,8,8505,12,393,405,False
2011-12-21,9,8506,14,220,234,False
2011-12-21,10,8507,6,83,89,False
2011-12-21,11,8508,3,53,56,False
2011-12-21,12,8509,3,58,61,False
2011-12-21,13,8510,3,55,58,False
2011-12-21,14,8511,11,40,51,False
2011-12-21,15,8512,4,57,61,False
2011-12-21,16,8513,6,95,101,False
2011-12-21,17,8514,3,226,229,False
2011-12-21,18,8515,2,278,280,False
2011-12-21,19,8516,9,200,209,False
2011-12-21,20,8517,5,162,167,False
2011-12-21,21,8518,9,114,123,False
2011-12-21,22,8519,3,102,105,False
2011-12-21,23,8520,0,54,54,False
2011-12-22,0,8521,3,24,27,False
2011-12-22,1,8522,0,15,15,False
2011-12-22,2,8523,1,10,11,False
2011-12-22,3,8524,0,6,6,False
2011-12-22,4,8525,0,3,3,False
2011-12-22,5,8526,1,15,16,False
2011-12-22,6,8527,1,63,64,False
2011-12-22,7,8528,4,182,186,False
2011-12-22,8,8529,10,333,343,False
2011-12-22,9,8530,10,218,228,False
2011-12-22,10,8531,13,128,141,False
2011-12-22,11,8532,10,135,145,False
2011-12-22,12,8533,22,180,202,False
2011-12-22,13,8534,21,167,188,False
2011-12-22,14,8535,23,136,159,False
2011-12-22,15,8536,28,186,214,False
2011-12-22,16,8537,30,226,256,False
2011-12-22,17,8538,24,332,356,False
2011-12-22,18,8539,11,277,288,False
2011-12-22,19,8540,12,130,142,False
2011-12-22,20,8541,0,33,33,False
2011-12-22,21,8542,2,15,17,False
2011-12-22,22,8543,0,17,17,False
2011-12-22,23,8544,1,10,11,False
2011-12-23,0,8545,2,7,9,False
2011-12-23,1,8546,1,11,12,False
2011-12-23,2,8547,1,12,13,False
2011-12-23,3,8548,0,4,4,False
2011-12-23,4,8549,0,2,2,False
2011-12-23,5,8550,0,8,8,False
2011-12-23,6,8551,0,40,40,False
2011-12-23,7,8552,4,88,92,False
2011-12-23,8,8553,9,173,182,False
2011-12-23,9,8554,4,152,156,False
2011-12-23,10,8555,8,96,104,False
2011-12-23,11,8556,26,148,174,False
2011-12-23,12,8557,14,156,170,False
2011-12-23,13,8558,17,177,194,False
2011-12-23,14,8559,23,177,200,False
2011-12-23,15,8560,12,191,203,False
2011-12-23,16,8561,15,166,181,False
2011-12-23,17,8562,11,129,140,False
2011-12-23,18,8563,4,91,95,False
2011-12-23,19,8564,1,75,76,False
2011-12-23,20,8565,3,47,50,False
2011-12-23,21,8566,0,32,32,False
2011-12-23,22,8567,4,43,47,False
2011-12-23,23,8568,4,21,25,False
2011-12-24,0,8569,3,20,23,False
2011-12-24,1,8570,1,15,16,False
2011-12-24,2,8571,4,22,26,False
2011-12-24,3,8572,0,5,5,False
2011-12-24,4,8573,0,3,3,False
2011-12-24,5,8574,1,3,4,False
2011-12-24,6,8575,0,10,10,False
2011-12-24,7,8576,0,10,10,False
2011-12-24,8,8577,0,27,27,False
2011-12-24,9,8578,3,53,56,False
2011-12-24,10,8579,4,52,56,False
2011-12-24,11,8580,9,62,71,False
2011-12-24,12,8581,15,79,94,False
2011-12-24,13,8582,24,97,121,False
2011-12-24,14,8583,15,70,85,False
2011-12-24,15,8584,15,82,97,False
2011-12-24,16,8585,25,74,99,False
2011-12-24,17,8586,15,53,68,False
2011-12-24,18,8587,2,33,35,False
2011-12-24,19,8588,1,24,25,False
2011-12-24,20,8589,5,19,24,False
2011-12-24,21,8590,4,15,19,False
2011-12-24,22,8591,8,12,20,False
2011-12-24,23,8592,1,16,17,False
2011-12-25,0,8593,2,4,6,False
2011-12-25,1,8594,2,2,4,False
2011-12-25,2,8595,0,2,2,False
2011-12-25,3,8596,1,3,4,False
2011-12-25,4,8597,1,5,6,True
2011-12-25,5,8598,0,1,1,False
2011-12-25,6,8599,0,1,1,False
2011-12-25,7,8600,0,4,4,False
2011-12-25,8,8601,1,4,5,False
2011-12-25,9,8602,3,20,23,False
2011-12-25,10,8603,31,12,43,False
2011-12-25,11,8604,43,42,85,False
2011-12-25,12,8605,25,41,66,False
2011-12-25,13,8606,40,39,79,False
2011-12-25,14,8607,41,45,86,False
2011-12-25,15,8608,43,48,91,False
2011-12-25,16,8609,35,51,86,False
2011-12-25,17,8610,11,33,44,False
2011-12-25,18,8611,7,23,30,False
2011-12-25,19,8612,2,14,16,False
2011-12-25,20,8613,8,18,26,False
2011-12-25,21,8614,4,15,19,False
2011-12-25,22,8615,2,15,17,False
2011-12-25,23,8616,2,14,16,False
2011-12-26,0,8617,5,6,11,False
2011-12-26,1,8618,3,7,10,False
2011-12-26,2,8619,2,5,7,False
2011-12-26,3,8620,3,9,12,True
2011-12-26,4,8621,0,2,2,False
2011-12-26,5,8622,0,4,4,False
2011-12-26,6,8623,0,4,4,False
2011-12-26,7,8624,2,17,19,False
2011-12-26,8,8625,5,13,18,False
2011-12-26,9,8626,24,38,62,False
2011-12-26,10,8627,31,39,70,False
2011-12-26,11,8628,40,51,91,False
2011-12-26,12,8629,34,66,100,False
2011-12-26,13,8630,57,83,140,False
2011-12-26,14,8631,73,80,153,False
2011-12-26,15,8632,26,105,131,False
2011-12-26,16,8633,28,69,97,False
2011-12-26,17,8634,30,67,97,False
2011-12-26,18,8635,21,54,75,False
2011-12-26,19,8636,16,49,65,False
2011-12-26,20,8637,14,42,56,False
2011-12-26,21,8638,10,39,49,False
2011-12-26,22,8639,5,22,27,False
2011-12-26,23,8640,4,25,29,False
2011-12-27,0,8641,3,9,12,False
2011-12-27,1,8642,0,6,6,False
2011-12-27,2,8643,2,2,4,False
2011-12-27,3,8644,0,3,3,False
2011-12-27,4,8645,0,3,3,False
2011-12-27,5,8646,0,8,8,False
2011-12-27,6,8647,0,35,35,False
2011-12-27,7,8648,1,79,80,False
2011-12-27,8,8649,9,155,164,False
2011-12-27,9,8650,19,85,104,False
2011-12-27,10,8651,13,47,60,False
2011-12-27,11,8652,6,24,30,False
2011-12-27,12,8653,8,16,24,False
2011-12-27,13,8654,1,19,20,False
2011-12-27,14,8655,0,14,14,False
2011-12-27,15,8656,2,17,19,False
2011-12-27,16,8657,2,44,46,False
2011-12-27,17,8658,6,109,115,False
2011-12-27,18,8659,9,126,135,False
2011-12-27,19,8660,3,87,90,False
2011-12-27,20,8661,3,66,69,False
2011-12-27,21,8662,11,52,63,False
2011-12-27,22,8663,3,29,32,False
2011-12-27,23,8664,2,24,26,False
2011-12-28,0,8665,0,10,10,False
2011-12-28,1,8666,0,12,12,False
2011-12-28,2,8667,0,7,7,False
2011-12-28,3,8668,0,4,4,False
2011-12-28,4,8669,1,5,6,True
2011-12-28,5,8670,0,9,9,False
2011-12-28,6,8671,1,42,43,False
2011-12-28,7,8672,4,106,110,False
2011-12-28,8,8673,11,206,217,False
2011-12-28,9,8674,18,171,189,False
2011-12-28,10,8675,12,84,96,False
2011-12-28,11,8676,18,93,111,False
2011-12-28,12,8677,32,108,140,False
2011-12-28,13,8678,24,135,159,False
2011-12-28,14,8679,24,96,120,False
2011-12-28,15,8680,16,101,117,False
2011-12-28,16,8681,23,144,167,False
2011-12-28,17,8682,25,225,250,False
2011-12-28,18,8683,10,159,169,False
2011-12-28,19,8684,16,135,151,False
2011-12-28,20,8685,9,70,79,False
2011-12-28,21,8686,7,63,70,False
2011-12-28,22,8687,2,31,33,False
2011-12-28,23,8688,3,36,39,False
2011-12-29,0,8689,4,24,28,False
2011-12-29,1,8690,0,15,15,False
2011-12-29,2,8691,0,3,3,False
2011-12-29,3,8692,0,2,2,False
2011-12-29,4,8693,1,2,3,False
2011-12-29,5,8694,0,10,10,False
2011-12-29,6,8695,2,39,41,False
2011-12-29,7,8696,2,104,106,False
2011-12-29,8,8697,3,207,210,False
2011-12-29,9,8698,15,155,170,False
2011-12-29,10,8699,13,97,110,False
2011-12-29,11,8700,23,99,122,False
2011-12-29,12,8701,12,118,130,False
2011-12-29,13,8702,36,95,131,False
2011-12-29,14,8703,30,112,142,False
2011-12-29,15,8704,27,150,177,False
2011-12-29,16,8705,22,155,177,False
2011-12-29,17,8706,14,226,240,False
2011-12-29,18,8707,15,192,207,False
2011-12-29,19,8708,11,124,135,False
2011-12-29,20,8709,8,88,96,False
2011-12-29,21,8710,8,60,68,False
2011-12-29,22,8711,7,48,55,False
2011-12-29,23,8712,1,44,45,False
2011-12-30,0,8713,4,26,30,False
2011-12-30,1,8714,9,11,20,False
2011-12-30,2,8715,2,10,12,False
2011-12-30,3,8716,0,6,6,False
2011-12-30,4,8717,0,2,2,False
2011-12-30,5,8718,0,10,10,False
2011-12-30,6,8719,1,31,32,False
2011-12-30,7,8720,3,92,95,False
2011-12-30,8,8721,12,193,205,False
2011-12-30,9,8722,19,175,194,False
2011-12-30,10,8723,10,108,118,False
2011-12-30,11,8724,45,126,171,False
2011-12-30,12,8725,38,159,197,False
2011-12-30,13,8726,53,154,207,False
2011-12-30,14,8727,67,178,245,False
2011-12-30,15,8728,56,236,292,False
2011-12-30,16,8729,36,247,283,False
2011-12-30,17,8730,54,188,242,False
2011-12-30,18,8731,19,163,182,False
2011-12-30,19,8732,16,96,112,False
2011-12-30,20,8733,16,75,91,False
2011-12-30,21,8734,11,84,95,False
2011-12-30,22,8735,7,78,85,False
2011-12-30,23,8736,13,60,73,False
2011-12-31,0,8737,7,37,44,False
2011-12-31,1,8738,4,31,35,False
2011-12-31,2,8739,1,27,28,False
2011-12-31,3,8740,1,17,18,False
2011-12-31,4,8741,1,9,10,False
2011-12-31,5,8742,1,0,1,False
2011-12-31,6,8743,1,5,6,False
2011-12-31,7,8744,6,13,19,False
2011-12-31,8,8745,7,42,49,False
2011-12-31,9,8746,18,72,90,False
2011-12-31,10,8747,20,108,128,False
2011-12-31,11,8748,65,152,217,False
2011-12-31,12,8749,93,180,273,False
2011-12-31,13,8750,108,205,313,False
2011-12-31,14,8751,115,185,300,False
2011-12-31,15,8752,89,164,253,False
2011-12-31,16,8753,52,143,195,False
2011-12-31,17,8754,28,101,129,False
2011-12-31,18,8755,13,80,93,False
2011-12-31,19,8756,19,73,92,False
2011-12-31,20,8757,8,63,71,False
2011-12-31,21,8758,2,50,52,False
2011-12-31,22,8759,2,36,38,False
2011-12-31,23,8760,4,27,31,False
2012-01-01,0,8761,5,43,48,False
2012-01-01,1,8762,15,78,93,False
2012-01-01,2,8763,16,59,75,False
2012-01-01,3,8764,11,41,52,False
2012-01-01,4,8765,0,8,8,False
2012-01-01,5,8766,0,5,5,False
2012-01-01,6,8767,1,1,2,False
2012-01-01,7,8768,1,6,7,False
2012-01-01,8,8769,4,10,14,False
2012-01-01,9,8770,13,27,40,False
2012-01-01,10,8771,18,52,70,False
2012-01-01,11,8772,40,98,138,False
2012-01-01,12,8773,58,143,201,False
2012-01-01,13,8774,82,141,223,False
2012-01-01,14,8775,120,147,267,False
2012-01-01,15,8776,101,164,265,False
2012-01-01,16,8777,68,147,215,False
2012-01-01,17,8778,36,75,111,False
2012-01-01,18,8779,25,81,106,False
2012-01-01,19,8780,20,85,105,False
2012-01-01,20,8781,25,58,83,False
2012-01-01,21,8782,10,61,71,False
2012-01-01,22,8783,13,53,66,False
2012-01-01,23,8784,4,25,29,False
2012-01-02,0,8785,8,31,39,False
2012-01-02,1,8786,1,11,12,False
2012-01-02,2,8787,1,6,7,False
2012-01-02,3,8788,3,9,12,True
2012-01-02,4,8789,0,4,4,False
2012-01-02,5,8790,1,3,4,False
2012-01-02,6,8791,0,14,14,False
2012-01-02,7,8792,0,16,16,False
2012-01-02,8,8793,2,51,53,False
2012-01-02,9,8794,15,53,68,False
2012-01-02,10,8795,20,89,109,False
2012-01-02,11,8796,33,142,175,False
2012-01-02,12,8797,41,161,202,False
2012-01-02,13,8798,26,150,176,False
2012-01-02,14,8799,10,141,151,False
2012-01-02,15,8800,29,139,168,False
2012-01-02,16,8801,10,144,154,False
2012-01-02,17,8802,17,136,153,False
2012-01-02,18,8803,13,113,126,False
2012-01-02,19,8804,4,89,93,False
2012-01-02,20,8805,5,83,88,False
2012-01-02,21,8806,3,63,66,False
2012-01-02,22,8807,3,36,39,False
2012-01-02,23,8808,2,32,34,False
2012-01-03,0,8809,0,13,13,False
2012-01-03,1,8810,1,5,6,False
2012-01-03,2,8811,0,3,3,False
2012-01-03,3,8812,0,2,2,False
2012-01-03,4,8813,0,5,5,False
2012-01-03,5,8814,0,12,12,False
2012-01-03,6,8815,4,81,85,False
2012-01-03,7,8816,2,168,170,False
2012-01-03,8,8817,5,349,354,False
2012-01-03,9,8818,8,145,153,False
2012-01-03,10,8819,5,55,60,False
2012-01-03,11,8820,12,63,75,False
2012-01-03,12,8821,4,70,74,False
2012-01-03,13,8822,5,68,73,False
2012-01-03,14,8823,7,72,79,False
2012-01-03,15,8824,9,68,77,False
2012-01-03,16,8825,7,129,136,False
2012-01-03,17,8826,4,241,245,False
2012-01-03,18,8827,10,214,224,False
2012-01-03,19,8828,4,152,156,False
2012-01-03,20,8829,0,115,115,False
2012-01-03,21,8830,2,66,68,False
2012-01-03,22,8831,0,33,33,False
2012-01-03,23,8832,0,18,18,False
2012-01-04,0,8833,0,9,9,False
2012-01-04,1,8834,0,3,3,False
2012-01-04,2,8835,0,1,1,False
2012-01-04,3,8836,0,1,1,False
2012-01-04,4,8837,0,2,2,False
2012-01-04,5,8838,0,14,14,False
2012-01-04,6,8839,0,59,59,False
2012-01-04,7,8840,1,151,152,False
2012-01-04,8,8841,5,310,315,False
2012-01-04,9,8842,7,173,180,False
2012-01-04,10,8843,7,57,64,False
2012-01-04,11,8844,6,40,46,False
2012-01-04,12,8845,9,75,84,False
2012-01-04,13,8846,9,82,91,False
2012-01-04,14,8847,6,69,75,False
2012-01-04,15,8848,9,81,90,False
2012-01-04,16,8849,8,123,131,False
2012-01-04,17,8850,9,272,281,False
2012-01-04,18,8851,9,280,289,False
2012-01-04,19,8852,2,182,184,False
2012-01-04,20,8853,2,121,123,False
2012-01-04,21,8854,2,88,90,False
2012-01-04,22,8855,4,48,52,False
2012-01-04,23,8856,0,32,32,False
2012-01-05,0,8857,1,13,14,False
2012-01-05,1,8858,0,5,5,False
2012-01-05,2,8859,0,4,4,False
2012-01-05,3,8860,0,4,4,False
2012-01-05,4,8861,0,5,5,False
2012-01-05,5,8862,0,26,26,False
2012-01-05,6,8863,0,78,78,False
2012-01-05,7,8864,3,212,215,False
2012-01-05,8,8865,11,377,388,False
2012-01-05,9,8866,7,220,227,False
2012-01-05,10,8867,5,81,86,False
2012-01-05,11,8868,6,78,84,False
2012-01-05,12,8869,6,114,120,False
2012-01-05,13,8870,6,112,118,False
2012-01-05,14,8871,13,104,117,False
2012-01-05,15,8872,6,113,119,False
2012-01-05,16,8873,19,178,197,False
2012-01-05,17,8874,19,393,412,False
2012-01-05,18,8875,9,374,383,False
2012-01-05,19,8876,10,255,265,False
2012-01-05,20,8877,5,172,177,False
2012-01-05,21,8878,9,88,97,False
2012-01-05,22,8879,1,70,71,False
2012-01-05,23,8880,4,56,60,False
2012-01-06,0,8881,1,24,25,False
2012-01-06,1,8882,2,6,8,False
2012-01-06,2,8883,2,3,5,False
2012-01-06,3,8884,1,3,4,False
2012-01-06,4,8885,0,3,3,False
2012-01-06,5,8886,0,13,13,False
2012-01-06,6,8887,1,69,70,False
2012-01-06,7,8888,4,201,205,False
2012-01-06,8,8889,11,436,447,False
2012-01-06,9,8890,4,237,241,False
2012-01-06,10,8891,14,102,116,False
2012-01-06,11,8892,8,130,138,False
2012-01-06,12,8893,23,168,191,False
2012-01-06,13,8894,16,188,204,False
2012-01-06,14,8895,26,152,178,False
2012-01-06,15,8896,44,178,222,False
2012-01-06,16,8897,35,259,294,False
2012-01-06,17,8898,20,456,476,False
2012-01-06,18,8899,28,391,419,False
2012-01-06,19,8900,11,261,272,False
2012-01-06,20,8901,14,163,177,False
2012-01-06,21,8902,17,137,154,False
2012-01-06,22,8903,12,123,135,False
2012-01-06,23,8904,13,88,101,False
2012-01-07,0,8905,2,77,79,False
2012-01-07,1,8906,6,56,62,False
2012-01-07,2,8907,2,36,38,False
2012-01-07,3,8908,1,19,20,False
2012-01-07,4,8909,1,9,10,False
2012-01-07,5,8910,2,7,9,False
2012-01-07,6,8911,0,7,7,False
2012-01-07,7,8912,0,20,20,False
2012-01-07,8,8913,0,64,64,False
2012-01-07,9,8914,14,116,130,False
2012-01-07,10,8915,43,160,203,False
2012-01-07,11,8916,74,250,324,False
2012-01-07,12,8917,100,276,376,False
2012-01-07,13,8918,149,296,445,False
2012-01-07,14,8919,156,356,512,False
2012-01-07,15,8920,132,317,449,False
2012-01-07,16,8921,133,268,401,False
2012-01-07,17,8922,87,235,322,False
2012-01-07,18,8923,49,248,297,False
2012-01-07,19,8924,44,171,215,False
2012-01-07,20,8925,21,149,170,False
2012-01-07,21,8926,22,118,140,False
2012-01-07,22,8927,16,93,109,False
2012-01-07,23,8928,16,103,119,False
2012-01-08,0,8929,14,77,91,False
2012-01-08,1,8930,10,62,72,False
2012-01-08,2,8931,10,57,67,False
2012-01-08,3,8932,6,26,32,False
2012-01-08,4,8933,2,4,6,False
2012-01-08,5,8934,0,2,2,False
2012-01-08,6,8935,0,2,2,False
2012-01-08,7,8936,1,23,24,False
2012-01-08,8,8937,4,53,57,False
2012-01-08,9,8938,23,102,125,False
2012-01-08,10,8939,27,181,208,False
2012-01-08,11,8940,55,201,256,False
2012-01-08,12,8941,78,273,351,False
2012-01-08,13,8942,77,266,343,False
2012-01-08,14,8943,75,253,328,False
2012-01-08,15,8944,89,241,330,False
2012-01-08,16,8945,58,256,314,False
2012-01-08,17,8946,22,197,219,False
2012-01-08,18,8947,19,162,181,False
2012-01-08,19,8948,8,104,112,False
2012-01-08,20,8949,7,119,126,False
2012-01-08,21,8950,10,81,91,False
2012-01-08,22,8951,4,54,58,False
2012-01-08,23,8952,0,30,30,False
2012-01-09,0,8953,3,12,15,False
2012-01-09,1,8954,1,4,5,False
2012-01-09,2,8955,2,3,5,False
2012-01-09,3,8956,0,3,3,False
2012-01-09,4,8957,0,4,4,False
2012-01-09,5,8958,0,21,21,False
2012-01-09,6,8959,3,85,88,False
2012-01-09,7,8960,1,239,240,False
2012-01-09,8,8961,13,407,420,False
2012-01-09,9,8962,9,188,197,False
2012-01-09,10,8963,13,95,108,False
2012-01-09,11,8964,6,82,88,False
2012-01-09,12,8965,10,93,103,False
2012-01-09,13,8966,3,77,80,False
2012-01-09,14,8967,5,45,50,False
2012-01-09,15,8968,5,64,69,False
2012-01-09,16,8969,3,46,49,False
2012-01-09,17,8970,5,147,152,False
2012-01-09,18,8971,6,158,164,False
2012-01-09,19,8972,3,187,190,False
2012-01-09,20,8973,5,127,132,False
2012-01-09,21,8974,1,78,79,False
2012-01-09,22,8975,8,54,62,False
2012-01-09,23,8976,1,51,52,False
2012-01-10,0,8977,0,14,14,False
2012-01-10,1,8978,2,3,5,False
2012-01-10,2,8979,2,2,4,False
2012-01-10,3,8980,3,9,12,True
2012-01-10,4,8981,0,4,4,False
2012-01-10,5,8982,0,23,23,False
2012-01-10,6,8983,0,79,79,False
2012-01-10,7,8984,3,219,222,False
2012-01-10,8,8985,6,465,471,False
2012-01-10,9,8986,11,184,195,False
2012-01-10,10,8987,3,80,83,False
2012-01-10,11,8988,8,93,101,False
2012-01-10,12,8989,13,127,140,False
2012-01-10,13,8990,15,163,178,False
2012-01-10,14,8991,10,96,106,False
2012-01-10,15,8992,17,119,136,False
2012-01-10,16,8993,15,225,240,False
2012-01-10,17,8994,14,446,460,False
2012-01-10,18,8995,13,372,385,False
2012-01-10,19,8996,11,270,281,False
2012-01-10,20,8997,10,190,200,False
2012-01-10,21,8998,7,109,116,False
2012-01-10,22,8999,10,104,114,False
2012-01-10,23,9000,3,38,41,False
2012-01-11,0,9001,2,26,28,False
2012-01-11,1,9002,1,6,7,False
2012-01-11,2,9003,0,5,5,False
2012-01-11,3,9004,0,4,4,False
2012-01-11,4,9005,0,2,2,False
2012-01-11,5,9006,0,22,22,False
2012-01-11,6,9007,2,72,74,False
2012-01-11,7,9008,9,247,256,False
2012-01-11,8,9009,11,488,499,False
2012-01-11,9,9010,7,218,225,False
2012-01-11,10,9011,13,84,97,False
2012-01-11,11,9012,9,90,99,False
2012-01-11,12,9013,4,51,55,False
2012-01-11,13,9014,8,57,65,False
2012-01-11,14,9015,3,70,73,False
2012-01-11,15,9016,6,73,79,False
2012-01-11,16,9017,6,112,118,False
2012-01-11,17,9018,6,128,134,False
2012-01-11,18,9019,2,96,98,False
2012-01-11,19,9020,1,92,93,False
2012-01-11,20,9021,2,55,57,False
2012-01-11,21,9022,0,29,29,False
2012-01-11,22,9023,0,49,49,False
2012-01-11,23,9024,0,9,9,False
2012-01-12,0,9025,0,3,3,False
2012-01-12,1,9026,0,3,3,False
2012-01-12,2,9027,1,1,2,False
2012-01-12,3,9028,0,3,3,False
2012-01-12,4,9029,0,2,2,False
2012-01-12,5,9030,0,16,16,False
2012-01-12,6,9031,1,88,89,False
2012-01-12,7,9032,2,218,220,False
2012-01-12,8,9033,11,497,508,False
2012-01-12,9,9034,10,220,230,False
2012-01-12,10,9035,6,84,90,False
2012-01-12,11,9036,18,101,119,False
2012-01-12,12,9037,14,130,144,False
2012-01-12,13,9038,13,170,183,False
2012-01-12,14,9039,24,132,156,False
2012-01-12,15,9040,32,156,188,False
2012-01-12,16,9041,33,248,281,False
2012-01-12,17,9042,23,472,495,False
2012-01-12,18,9043,22,399,421,False
2012-01-12,19,9044,17,313,330,False
2012-01-12,20,9045,11,229,240,False
2012-01-12,21,9046,12,162,174,False
2012-01-12,22,9047,12,121,133,False
2012-01-12,23,9048,7,60,67,False
2012-01-13,0,9049,4,38,42,False
2012-01-13,1,9050,0,12,12,False
2012-01-13,2,9051,1,13,14,False
2012-01-13,3,9052,3,4,7,False
2012-01-13,4,9053,1,2,3,False
2012-01-13,5,9054,0,21,21,False
2012-01-13,6,9055,2,71,73,False
2012-01-13,7,9056,3,174,177,False
2012-01-13,8,9057,11,408,419,False
2012-01-13,9,9058,10,204,214,False
2012-01-13,10,9059,2,101,103,False
2012-01-13,11,9060,12,102,114,False
2012-01-13,12,9061,14,140,154,False
2012-01-13,13,9062,14,140,154,False
2012-01-13,14,9063,10,119,129,False
2012-01-13,15,9064,15,123,138,False
2012-01-13,16,9065,18,215,233,False
2012-01-13,17,9066,15,317,332,False
2012-01-13,18,9067,7,294,301,False
2012-01-13,19,9068,7,199,206,False
2012-01-13,20,9069,6,130,136,False
2012-01-13,21,9070,7,95,102,False
2012-01-13,22,9071,7,58,65,False
2012-01-13,23,9072,5,60,65,False
2012-01-14,0,9073,2,42,44,False
2012-01-14,1,9074,6,44,50,False
2012-01-14,2,9075,6,32,38,False
2012-01-14,3,9076,6,14,20,False
2012-01-14,4,9077,0,3,3,False
2012-01-14,5,9078,0,4,4,False
2012-01-14,6,9079,0,5,5,False
2012-01-14,7,9080,0,24,24,False
2012-01-14,8,9081,3,89,92,False
2012-01-14,9,9082,3,78,81,False
2012-01-14,10,9083,14,135,149,False
2012-01-14,11,9084,28,150,178,False
2012-01-14,12,9085,30,189,219,False
2012-01-14,13,9086,38,182,220,False
2012-01-14,14,9087,52,179,231,False
2012-01-14,15,9088,49,177,226,False
2012-01-14,16,9089,28,178,206,False
2012-01-14,17,9090,15,129,144,False
2012-01-14,18,9091,21,122,143,False
2012-01-14,19,9092,12,90,102,False
2012-01-14,20,9093,8,95,103,False
2012-01-14,21,9094,3,66,69,False
2012-01-14,22,9095,4,62,66,False
2012-01-14,23,9096,5,71,76,False
2012-01-15,0,9097,9,50,59,False
2012-01-15,1,9098,2,40,42,False
2012-01-15,2,9099,5,38,43,False
2012-01-15,3,9100,1,24,25,False
2012-01-15,4,9101,1,5,6,False
2012-01-15,5,9102,0,5,5,False
2012-01-15,6,9103,1,7,8,False
2012-01-15,7,9104,3,14,17,False
2012-01-15,8,9105,2,34,36,False
2012-01-15,9,9106,10,80,90,False
2012-01-15,10,9107,11,115,126,False
2012-01-15,11,9108,21,144,165,False
2012-01-15,12,9109,42,192,234,False
2012-01-15,13,9110,40,184,224,False
2012-01-15,14,9111,25,163,188,False
2012-01-15,15,9112,33,173,206,False
2012-01-15,16,9113,31,174,205,False
2012-01-15,17,9114,15,131,146,False
2012-01-15,18,9115,7,113,120,False
2012-01-15,19,9116,9,101,110,False
2012-01-15,20,9117,10,85,95,False
2012-01-15,21,9118,1,71,72,False
2012-01-15,22,9119,2,58,60,False
2012-01-15,23,9120,3,26,29,False
2012-01-16,0,9121,2,23,25,False
2012-01-16,1,9122,2,18,20,False
2012-01-16,2,9123,3,14,17,False
2012-01-16,3,9124,0,3,3,False
2012-01-16,4,9125,2,6,8,False
2012-01-16,5,9126,1,5,6,False
2012-01-16,6,9127,0,13,13,False
2012-01-16,7,9128,5,28,33,False
2012-01-16,8,9129,3,75,78,False
2012-01-16,9,9130,7,89,96,False
2012-01-16,10,9131,19,107,126,False
2012-01-16,11,9132,21,158,179,False
2012-01-16,12,9133,20,165,185,False
2012-01-16,13,9134,26,202,228,False
2012-01-16,14,9135,23,158,181,False
2012-01-16,15,9136,17,175,192,False
2012-01-16,16,9137,22,158,180,False
2012-01-16,17,9138,19,174,193,False
2012-01-16,18,9139,6,175,181,False
2012-01-16,19,9140,10,134,144,False
2012-01-16,20,9141,2,88,90,False
2012-01-16,21,9142,3,46,49,False
2012-01-16,22,9143,4,39,43,False
2012-01-16,23,9144,0,28,28,False
2012-01-17,0,9145,0,12,12,False
2012-01-17,1,9146,0,2,2,False
2012-01-17,2,9147,0,12,12,False
2012-01-17,3,9148,3,9,12,True
2012-01-17,4,9149,0,2,2,False
2012-01-17,5,9150,0,13,13,False
2012-01-17,6,9151,0,57,57,False
2012-01-17,7,9152,5,121,126,False
2012-01-17,8,9153,3,90,93,False
2012-01-17,9,9154,7,61,68,False
2012-01-17,10,9155,1,61,62,False
2012-01-17,11,9156,2,73,75,False
2012-01-17,12,9157,3,83,86,False
2012-01-17,13,9158,8,95,103,False
2012-01-17,14,9159,12,120,132,False
2012-01-17,15,9160,6,123,129,False
2012-01-17,16,9161,14,205,219,False
2012-01-17,17,9162,20,442,462,False
2012-01-17,18,9163,12,451,463,False
2012-01-17,19,9164,11,297,308,False
2012-01-17,20,9165,11,169,180,False
2012-01-17,21,9166,6,174,180,False
2012-01-17,22,9167,5,85,90,False
2012-01-17,23,9168,1,60,61,False
2012-01-18,0,9169,3,14,17,False
2012-01-18,1,9170,0,10,10,False
2012-01-18,2,9171,1,1,2,False
2012-01-18,3,9172,1,3,4,False
2012-01-18,4,9173,0,1,1,False
2012-01-18,5,9174,0,29,29,False
2012-01-18,6,9175,0,88,88,False
2012-01-18,7,9176,1,262,263,False
2012-01-18,8,9177,15,474,489,False
2012-01-18,9,9178,6,196,202,False
2012-01-18,10,9179,5,88,93,False
2012-01-18,11,9180,4,110,114,False
2012-01-18,12,9181,6,155,161,False
2012-01-18,13,9182,6,124,130,False
2012-01-18,14,9183,7,98,105,False
2012-01-18,15,9184,8,122,130,False
2012-01-18,16,9185,13,163,176,False
2012-01-18,17,9186,8,338,346,False
2012-01-18,18,9187,8,347,355,False
2012-01-18,19,9188,5,251,256,False
2012-01-18,20,9189,1,164,165,False
2012-01-18,21,9190,5,119,124,False
2012-01-18,22,9191,4,74,78,False
2012-01-18,23,9192,2,36,38,False
2012-01-19,0,9193,0,16,16,False
2012-01-19,1,9194,0,5,5,False
2012-01-19,2,9195,0,3,3,False
2012-01-19,3,9196,0,4,4,False
2012-01-19,4,9197,0,1,1,False
2012-01-19,5,9198,0,19,19,False
2012-01-19,6,9199,0,86,86,False
2012-01-19,7,9200,2,204,206,False
2012-01-19,8,9201,9,414,423,False
2012-01-19,9,9202,6,204,210,False
2012-01-19,10,9203,10,98,108,False
2012-01-19,11,9204,6,93,99,False
2012-01-19,12,9205,5,106,111,False
2012-01-19,13,9206,6,118,124,False
2012-01-19,14,9207,15,104,119,False
2012-01-19,15,9208,9,118,127,False
2012-01-19,16,9209,8,185,193,False
2012-01-19,17,9210,21,364,385,False
2012-01-19,18,9211,16,345,361,False
2012-01-19,19,9212,5,229,234,False
2012-01-19,20,9213,7,184,191,False
2012-01-19,21,9214,4,117,121,False
2012-01-19,22,9215,0,90,90,False
2012-01-19,23,9216,1,55,56,False
2012-01-20,0,9217,3,24,27,False
2012-01-20,1,9218,0,15,15,False
2012-01-20,2,9219,0,11,11,False
2012-01-20,3,9220,0,4,4,False
2012-01-20,4,9221,0,3,3,False
2012-01-20,5,9222,0,19,19,False
2012-01-20,6,9223,0,68,68,False
2012-01-20,7,9224,2,183,185,False
2012-01-20,8,9225,4,421,425,False
2012-01-20,9,9226,21,242,263,False
2012-01-20,10,9227,1,96,97,False
2012-01-20,11,9228,6,117,123,False
2012-01-20,12,9229,5,119,124,False
2012-01-20,13,9230,12,144,156,False
2012-01-20,14,9231,8,107,115,False
2012-01-20,15,9232,12,144,156,False
2012-01-20,16,9233,11,163,174,False
2012-01-20,17,9234,9,340,349,False
2012-01-20,18,9235,5,296,301,False
2012-01-20,19,9236,6,186,192,False
2012-01-20,20,9237,1,141,142,False
2012-01-20,21,9238,5,99,104,False
2012-01-20,22,9239,1,71,72,False
2012-01-20,23,9240,3,35,38,False
2012-01-21,0,9241,0,24,24,False
2012-01-21,1,9242,1,22,23,False
2012-01-21,2,9243,1,25,26,False
2012-01-21,3,9244,0,13,13,False
2012-01-21,4,9245,0,1,1,False
2012-01-21,5,9246,0,2,2,False
2012-01-21,6,9247,0,1,1,False
2012-01-21,7,9248,3,10,13,False
2012-01-21,8,9249,3,22,25,False
2012-01-21,9,9250,2,40,42,False
2012-01-21,10,9251,0,45,45,False
2012-01-21,11,9252,1,62,63,False
2012-01-21,12,9253,5,62,67,False
2012-01-21,13,9254,10,66,76,False
2012-01-21,14,9255,6,89,95,False
2012-01-21,15,9256,6,113,119,False
2012-01-21,16,9257,5,113,118,False
2012-01-21,17,9258,7,99,106,False
2012-01-21,18,9259,3,107,110,False
2012-01-21,19,9260,0,85,85,False
2012-01-21,20,9261,5,62,67,False
2012-01-21,21,9262,5,64,69,False
2012-01-21,22,9263,3,56,59,False
2012-01-21,23,9264,1,51,52,False
2012-01-22,0,9265,1,51,52,False
2012-01-22,1,9266,1,49,50,False
2012-01-22,2,9267,1,46,47,False
2012-01-22,3,9268,1,20,21,False
2012-01-22,4,9269,1,1,2,False
2012-01-22,5,9270,1,2,3,False
2012-01-22,6,9271,0,4,4,False
2012-01-22,7,9272,2,11,13,False
2012-01-22,8,9273,3,29,32,False
2012-01-22,9,9274,9,54,63,False
2012-01-22,10,9275,9,120,129,False
2012-01-22,11,9276,18,115,133,False
2012-01-22,12,9277,24,161,185,False
2012-01-22,13,9278,24,175,199,False
2012-01-22,14,9279,19,163,182,False
2012-01-22,15,9280,27,149,176,False
2012-01-22,16,9281,12,143,155,False
2012-01-22,17,9282,8,100,108,False
2012-01-22,18,9283,11,110,121,False
2012-01-22,19,9284,9,80,89,False
2012-01-22,20,9285,5,69,74,False
2012-01-22,21,9286,8,36,44,False
2012-01-22,22,9287,0,58,58,False
2012-01-22,23,9288,2,35,37,False
2012-01-23,0,9289,2,17,19,False
2012-01-23,1,9290,0,4,4,False
2012-01-23,2,9291,0,2,2,False
2012-01-23,3,9292,0,1,1,False
2012-01-23,4,9293,0,1,1,False
2012-01-23,5,9294,0,19,19,False
2012-01-23,6,9295,6,36,42,False
2012-01-23,7,9296,8,114,122,False
2012-01-23,8,9297,5,267,272,False
2012-01-23,9,9298,13,198,211,False
2012-01-23,10,9299,10,139,149,False
2012-01-23,11,9300,5,57,62,False
2012-01-23,12,9301,10,52,62,False
2012-01-23,13,9302,5,32,37,False
2012-01-23,14,9303,13,48,61,False
2012-01-23,15,9304,10,64,74,False
2012-01-23,16,9305,14,108,122,False
2012-01-23,17,9306,6,270,276,False
2012-01-23,18,9307,7,275,282,False
2012-01-23,19,9308,9,211,220,False
2012-01-23,20,9309,8,161,169,False
2012-01-23,21,9310,8,112,120,False
2012-01-23,22,9311,4,64,68,False
2012-01-23,23,9312,2,35,37,False
2012-01-24,0,9313,6,19,25,False
2012-01-24,1,9314,2,7,9,False
2012-01-24,2,9315,2,6,8,False
2012-01-24,3,9316,0,3,3,False
2012-01-24,4,9317,0,2,2,False
2012-01-24,5,9318,0,26,26,False
2012-01-24,6,9319,1,88,89,False
2012-01-24,7,9320,11,221,232,False
2012-01-24,8,9321,11,479,490,False
2012-01-24,9,9322,11,244,255,False
2012-01-24,10,9323,23,93,116,False
2012-01-24,11,9324,30,123,153,False
2012-01-24,12,9325,25,150,175,False
2012-01-24,13,9326,33,170,203,False
2012-01-24,14,9327,35,138,173,False
2012-01-24,15,9328,52,156,208,False
2012-01-24,16,9329,35,243,278,False
2012-01-24,17,9330,41,474,515,False
2012-01-24,18,9331,32,391,423,False
2012-01-24,19,9332,20,311,331,False
2012-01-24,20,9333,18,211,229,False
2012-01-24,21,9334,18,154,172,False
2012-01-24,22,9335,14,111,125,False
2012-01-24,23,9336,19,80,99,False
2012-01-25,0,9337,6,25,31,False
2012-01-25,1,9338,4,9,13,False
2012-01-25,2,9339,3,3,6,False
2012-01-25,3,9340,0,1,1,False
2012-01-25,4,9341,0,4,4,False
2012-01-25,5,9342,0,33,33,False
2012-01-25,6,9343,1,87,88,False
2012-01-25,7,9344,14,243,257,False
2012-01-25,8,9345,18,495,513,False
2012-01-25,9,9346,18,218,236,False
2012-01-25,10,9347,30,111,141,False
2012-01-25,11,9348,52,105,157,False
2012-01-25,12,9349,46,147,193,False
2012-01-25,13,9350,63,149,212,False
2012-01-25,14,9351,53,107,160,False
2012-01-25,15,9352,30,125,155,False
2012-01-25,16,9353,29,217,246,False
2012-01-25,17,9354,27,443,470,False
2012-01-25,18,9355,24,415,439,False
2012-01-25,19,9356,5,311,316,False
2012-01-25,20,9357,10,225,235,False
2012-01-25,21,9358,19,166,185,False
2012-01-25,22,9359,12,101,113,False
2012-01-25,23,9360,3,63,66,False
2012-01-26,0,9361,3,22,25,False
2012-01-26,1,9362,5,16,21,False
2012-01-26,2,9363,1,6,7,False
2012-01-26,3,9364,1,5,6,False
2012-01-26,4,9365,0,3,3,False
2012-01-26,5,9366,0,28,28,False
2012-01-26,6,9367,0,88,88,False
2012-01-26,7,9368,11,228,239,False
2012-01-26,8,9369,16,514,530,False
2012-01-26,9,9370,18,256,274,False
2012-01-26,10,9371,16,92,108,False
2012-01-26,11,9372,11,100,111,False
2012-01-26,12,9373,29,136,165,False
2012-01-26,13,9374,17,156,173,False
2012-01-26,14,9375,16,112,128,False
2012-01-26,15,9376,22,142,164,False
2012-01-26,16,9377,15,209,224,False
2012-01-26,17,9378,16,397,413,False
2012-01-26,18,9379,12,394,406,False
2012-01-26,19,9380,11,302,313,False
2012-01-26,20,9381,8,216,224,False
2012-01-26,21,9382,8,184,192,False
2012-01-26,22,9383,3,139,142,False
2012-01-26,23,9384,5,86,91,False
2012-01-27,0,9385,6,32,38,False
2012-01-27,1,9386,6,23,29,False
2012-01-27,2,9387,2,11,13,False
2012-01-27,3,9388,3,5,8,False
2012-01-27,4,9389,1,3,4,False
2012-01-27,5,9390,0,24,24,False
2012-01-27,6,9391,0,72,72,False
2012-01-27,7,9392,6,128,134,False
2012-01-27,8,9393,14,206,220,False
2012-01-27,9,9394,6,101,107,False
2012-01-27,10,9395,9,117,126,False
2012-01-27,11,9396,10,95,105,False
2012-01-27,12,9397,25,155,180,False
2012-01-27,13,9398,26,175,201,False
2012-01-27,14,9399,23,153,176,False
2012-01-27,15,9400,27,170,197,False
2012-01-27,16,9401,26,241,267,False
2012-01-27,17,9402,16,406,422,False
2012-01-27,18,9403,20,363,383,False
2012-01-27,19,9404,10,241,251,False
2012-01-27,20,9405,6,153,159,False
2012-01-27,21,9406,8,127,135,False
2012-01-27,22,9407,11,108,119,False
2012-01-27,23,9408,8,78,86,False
2012-01-28,0,9409,1,68,69,False
2012-01-28,1,9410,1,57,58,False
2012-01-28,2,9411,3,38,41,False
2012-01-28,3,9412,1,16,17,False
2012-01-28,4,9413,0,8,8,False
2012-01-28,5,9414,0,10,10,False
2012-01-28,6,9415,3,12,15,False
2012-01-28,7,9416,3,28,31,False
2012-01-28,8,9417,9,82,91,False
2012-01-28,9,9418,13,145,158,False
2012-01-28,10,9419,27,164,191,False
2012-01-28,11,9420,55,241,296,False
2012-01-28,12,9421,70,244,314,False
2012-01-28,13,9422,80,293,373,False
2012-01-28,14,9423,123,239,362,False
2012-01-28,15,9424,90,320,410,False
2012-01-28,16,9425,131,276,407,False
2012-01-28,17,9426,57,233,290,False
2012-01-28,18,9427,40,201,241,False
2012-01-28,19,9428,33,173,206,False
2012-01-28,20,9429,5,115,120,False
2012-01-28,21,9430,18,109,127,False
2012-01-28,22,9431,6,97,103,False
2012-01-28,23,9432,6,79,85,False
2012-01-29,0,9433,15,81,96,False
2012-01-29,1,9434,5,68,73,False
2012-01-29,2,9435,3,48,51,False
2012-01-29,3,9436,4,17,21,False
2012-01-29,4,9437,0,5,5,False
2012-01-29,5,9438,1,6,7,False
2012-01-29,6,9439,1,4,5,False
2012-01-29,7,9440,0,12,12,False
2012-01-29,8,9441,9,61,70,False
2012-01-29,9,9442,13,98,111,False
2012-01-29,10,9443,38,153,191,False
2012-01-29,11,9444,57,198,255,False
2012-01-29,12,9445,73,215,288,False
2012-01-29,13,9446,78,238,316,False
2012-01-29,14,9447,51,229,280,False
2012-01-29,15,9448,68,242,310,False
2012-01-29,16,9449,54,268,322,False
2012-01-29,17,9450,33,201,234,False
2012-01-29,18,9451,17,151,168,False
2012-01-29,19,9452,14,145,159,False
2012-01-29,20,9453,13,98,111,False
2012-01-29,21,9454,0,69,69,False
2012-01-29,22,9455,7,57,64,False
2012-01-29,23,9456,4,21,25,False
2012-01-30,0,9457,0,10,10,False
2012-01-30,1,9458,0,9,9,False
2012-01-30,2,9459,1,6,7,False
2012-01-30,3,9460,0,4,4,False
2012-01-30,4,9461,0,5,5,False
2012-01-30,5,9462,0,26,26,False
2012-01-30,6,9463,0,80,80,False
2012-01-30,7,9464,4,221,225,False
2012-01-30,8,9465,12,481,493,False
2012-01-30,9,9466,5,193,198,False
2012-01-30,10,9467,3,82,85,False
2012-01-30,11,9468,6,93,99,False
2012-01-30,12,9469,5,129,134,False
2012-01-30,13,9470,15,117,132,False
2012-01-30,14,9471,15,100,115,False
2012-01-30,15,9472,7,131,138,False
2012-01-30,16,9473,11,210,221,False
2012-01-30,17,9474,16,422,438,False
2012-01-30,18,9475,11,399,410,False
2012-01-30,19,9476,8,298,306,False
2012-01-30,20,9477,2,179,181,False
2012-01-30,21,9478,3,159,162,False
2012-01-30,22,9479,2,92,94,False
2012-01-30,23,9480,0,52,52,False
2012-01-31,0,9481,0,15,15,False
2012-01-31,1,9482,1,7,8,False
2012-01-31,2,9483,0,2,2,False
2012-01-31,3,9484,0,2,2,False
2012-01-31,4,9485,0,1,1,False
2012-01-31,5,9486,0,22,22,False
2012-01-31,6,9487,0,104,104,False
2012-01-31,7,9488,6,273,279,False
2012-01-31,8,9489,14,498,512,False
2012-01-31,9,9490,30,231,261,False
2012-01-31,10,9491,34,110,144,False
2012-01-31,11,9492,14,125,139,False
2012-01-31,12,9493,13,181,194,False
2012-01-31,13,9494,27,171,198,False
2012-01-31,14,9495,18,142,160,False
2012-01-31,15,9496,27,150,177,False
2012-01-31,16,9497,30,277,307,False
2012-01-31,17,9498,41,518,559,False
2012-01-31,18,9499,16,486,502,False
2012-01-31,19,9500,22,306,328,False
2012-01-31,20,9501,15,223,238,False
2012-01-31,21,9502,3,162,165,False
2012-01-31,22,9503,11,118,129,False
2012-01-31,23,9504,2,61,63,False
2012-02-01,0,9505,0,31,31,False
2012-02-01,1,9506,0,4,4,False
2012-02-01,2,9507,1,6,7,False
2012-02-01,3,9508,0,3,3,False
2012-02-01,4,9509,0,1,1,False
2012-02-01,5,9510,0,18,18,False
2012-02-01,6,9511,0,67,67,False
2012-02-01,7,9512,7,201,208,False
2012-02-01,8,9513,15,505,520,False
2012-02-01,9,9514,9,267,276,False
2012-02-01,10,9515,9,124,133,False
2012-02-01,11,9516,27,116,143,False
2012-02-01,12,9517,26,153,179,False
2012-02-01,13,9518,12,174,186,False
2012-02-01,14,9519,33,159,192,False
2012-02-01,15,9520,25,169,194,False
2012-02-01,16,9521,22,261,283,False
2012-02-01,17,9522,31,508,539,False
2012-02-01,18,9523,12,514,526,False
2012-02-01,19,9524,20,315,335,False
2012-02-01,20,9525,10,254,264,False
2012-02-01,21,9526,16,217,233,False
2012-02-01,22,9527,7,133,140,False
2012-02-01,23,9528,22,75,97,False
2012-02-02,0,9529,7,24,31,False
2012-02-02,1,9530,3,14,17,False
2012-02-02,2,9531,2,7,9,False
2012-02-02,3,9532,0,2,2,False
2012-02-02,4,9533,0,1,1,False
2012-02-02,5,9534,0,19,19,False
2012-02-02,6,9535,1,73,74,False
2012-02-02,7,9536,4,201,205,False
2012-02-02,8,9537,9,436,445,False
2012-02-02,9,9538,15,213,228,False
2012-02-02,10,9539,6,72,78,False
2012-02-02,11,9540,6,99,105,False
2012-02-02,12,9541,8,140,148,False
2012-02-02,13,9542,13,124,137,False
2012-02-02,14,9543,12,129,141,False
2012-02-02,15,9544,24,150,174,False
2012-02-02,16,9545,18,211,229,False
2012-02-02,17,9546,13,437,450,False
2012-02-02,18,9547,17,393,410,False
2012-02-02,19,9548,16,311,327,False
2012-02-02,20,9549,9,204,213,False
2012-02-02,21,9550,4,144,148,False
2012-02-02,22,9551,3,106,109,False
2012-02-02,23,9552,0,61,61,False
2012-02-03,0,9553,1,37,38,False
2012-02-03,1,9554,3,19,22,False
2012-02-03,2,9555,0,6,6,False
2012-02-03,3,9556,0,4,4,False
2012-02-03,4,9557,0,2,2,False
2012-02-03,5,9558,0,17,17,False
2012-02-03,6,9559,0,88,88,False
2012-02-03,7,9560,10,216,226,False
2012-02-03,8,9561,12,429,441,False
2012-02-03,9,9562,18,252,270,False
2012-02-03,10,9563,15,114,129,False
2012-02-03,11,9564,15,149,164,False
2012-02-03,12,9565,25,191,216,False
2012-02-03,13,9566,25,173,198,False
2012-02-03,14,9567,22,148,170,False
2012-02-03,15,9568,48,168,216,False
2012-02-03,16,9569,36,275,311,False
2012-02-03,17,9570,30,458,488,False
2012-02-03,18,9571,17,368,385,False
2012-02-03,19,9572,11,256,267,False
2012-02-03,20,9573,8,155,163,False
2012-02-03,21,9574,8,126,134,False
2012-02-03,22,9575,3,116,119,False
2012-02-03,23,9576,3,74,77,False
2012-02-04,0,9577,10,76,86,False
2012-02-04,1,9578,0,43,43,False
2012-02-04,2,9579,6,38,44,False
2012-02-04,3,9580,1,17,18,False
2012-02-04,4,9581,1,5,6,False
2012-02-04,5,9582,1,3,4,False
2012-02-04,6,9583,1,4,5,False
2012-02-04,7,9584,1,27,28,False
2012-02-04,8,9585,4,86,90,False
2012-02-04,9,9586,16,141,157,False
2012-02-04,10,9587,31,193,224,False
2012-02-04,11,9588,46,224,270,False
2012-02-04,12,9589,40,260,300,False
2012-02-04,13,9590,58,244,302,False
2012-02-04,14,9591,47,229,276,False
2012-02-04,15,9592,61,244,305,False
2012-02-04,16,9593,20,123,143,False
2012-02-04,17,9594,13,54,67,False
2012-02-04,18,9595,6,58,64,False
2012-02-04,19,9596,5,75,80,False
2012-02-04,20,9597,4,73,77,False
2012-02-04,21,9598,4,74,78,False
2012-02-04,22,9599,4,91,95,False
2012-02-04,23,9600,4,66,70,False
2012-02-05,0,9601,3,58,61,False
2012-02-05,1,9602,5,46,51,False
2012-02-05,2,9603,4,59,63,False
2012-02-05,3,9604,4,13,17,False
2012-02-05,4,9605,0,9,9,False
2012-02-05,5,9606,0,4,4,False
2012-02-05,6,9607,0,4,4,False
2012-02-05,7,9608,0,16,16,False
2012-02-05,8,9609,4,58,62,False
2012-02-05,9,9610,9,83,92,False
2012-02-05,10,9611,10,138,148,False
2012-02-05,11,9612,22,160,182,False
2012-02-05,12,9613,25,223,248,False
2012-02-05,13,9614,33,241,274,False
2012-02-05,14,9615,40,203,243,False
2012-02-05,15,9616,55,217,272,False
2012-02-05,16,9617,35,261,296,False
2012-02-05,17,9618,31,275,306,False
2012-02-05,18,9619,10,171,181,False
2012-02-05,19,9620,6,63,69,False
2012-02-05,20,9621,3,47,50,False
2012-02-05,21,9622,6,60,66,False
2012-02-05,22,9623,9,182,191,False
2012-02-05,23,9624,4,38,42,False
2012-02-06,0,9625,7,14,21,False
2012-02-06,1,9626,0,6,6,False
2012-02-06,2,9627,0,3,3,False
2012-02-06,3,9628,3,9,12,True
2012-02-06,4,9629,0,2,2,False
2012-02-06,5,9630,0,17,17,False
2012-02-06,6,9631,0,72,72,False
2012-02-06,7,9632,5,229,234,False
2012-02-06,8,9633,10,434,444,False
2012-02-06,9,9634,8,269,277,False
2012-02-06,10,9635,20,96,116,False
2012-02-06,11,9636,12,104,116,False
2012-02-06,12,9637,19,131,150,False
2012-02-06,13,9638,17,124,141,False
2012-02-06,14,9639,14,126,140,False
2012-02-06,15,9640,25,146,171,False
2012-02-06,16,9641,13,215,228,False
2012-02-06,17,9642,13,417,430,False
2012-02-06,18,9643,11,426,437,False
2012-02-06,19,9644,7,284,291,False
2012-02-06,20,9645,7,194,201,False
2012-02-06,21,9646,11,143,154,False
2012-02-06,22,9647,4,83,87,False
2012-02-06,23,9648,3,43,46,False
2012-02-07,0,9649,1,22,23,False
2012-02-07,1,9650,8,6,14,False
2012-02-07,2,9651,0,4,4,False
2012-02-07,3,9652,1,1,2,False
2012-02-07,4,9653,0,3,3,False
2012-02-07,5,9654,0,15,15,False
2012-02-07,6,9655,2,98,100,False
2012-02-07,7,9656,6,293,299,False
2012-02-07,8,9657,7,522,529,False
2012-02-07,9,9658,11,278,289,False
2012-02-07,10,9659,12,104,116,False
2012-02-07,11,9660,9,120,129,False
2012-02-07,12,9661,9,163,172,False
2012-02-07,13,9662,15,169,184,False
2012-02-07,14,9663,11,127,138,False
2012-02-07,15,9664,13,133,146,False
2012-02-07,16,9665,19,257,276,False
2012-02-07,17,9666,15,494,509,False
2012-02-07,18,9667,10,508,518,False
2012-02-07,19,9668,11,327,338,False
2012-02-07,20,9669,6,206,212,False
2012-02-07,21,9670,20,170,190,False
2012-02-07,22,9671,11,107,118,False
2012-02-07,23,9672,2,49,51,False
2012-02-08,0,9673,2,21,23,False
2012-02-08,1,9674,1,9,10,False
2012-02-08,2,9675,0,1,1,False
2012-02-08,3,9676,0,1,1,False
2012-02-08,4,9677,0,1,1,False
2012-02-08,5,9678,0,20,20,False
2012-02-08,6,9679,3,95,98,False
2012-02-08,7,9680,5,276,281,False
2012-02-08,8,9681,13,495,508,False
2012-02-08,9,9682,8,245,253,False
2012-02-08,10,9683,1,107,108,False
2012-02-08,11,9684,5,97,102,False
2012-02-08,12,9685,14,124,138,False
2012-02-08,13,9686,15,111,126,False
2012-02-08,14,9687,8,100,108,False
2012-02-08,15,9688,5,49,54,False
2012-02-08,16,9689,2,73,75,False
2012-02-08,17,9690,8,147,155,False
2012-02-08,18,9691,4,163,167,False
2012-02-08,19,9692,3,158,161,False
2012-02-08,20,9693,3,122,125,False
2012-02-08,21,9694,3,126,129,False
2012-02-08,22,9695,3,95,98,False
2012-02-08,23,9696,3,57,60,False
2012-02-09,0,9697,3,23,26,False
2012-02-09,1,9698,2,10,12,False
2012-02-09,2,9699,0,2,2,False
2012-02-09,3,9700,0,4,4,False
2012-02-09,4,9701,0,1,1,False
2012-02-09,5,9702,0,18,18,False
2012-02-09,6,9703,1,75,76,False
2012-02-09,7,9704,4,263,267,False
2012-02-09,8,9705,11,473,484,False
2012-02-09,9,9706,9,229,238,False
2012-02-09,10,9707,7,90,97,False
2012-02-09,11,9708,4,95,99,False
2012-02-09,12,9709,10,148,158,False
2012-02-09,13,9710,10,144,154,False
2012-02-09,14,9711,18,126,144,False
2012-02-09,15,9712,14,120,134,False
2012-02-09,16,9713,15,223,238,False
2012-02-09,17,9714,12,387,399,False
2012-02-09,18,9715,13,404,417,False
2012-02-09,19,9716,8,287,295,False
2012-02-09,20,9717,2,197,199,False
2012-02-09,21,9718,8,169,177,False
2012-02-09,22,9719,3,104,107,False
2012-02-09,23,9720,9,75,84,False
2012-02-10,0,9721,4,39,43,False
2012-02-10,1,9722,2,11,13,False
2012-02-10,2,9723,7,9,16,False
2012-02-10,3,9724,0,5,5,False
2012-02-10,4,9725,0,2,2,False
2012-02-10,5,9726,0,17,17,False
2012-02-10,6,9727,3,61,64,False
2012-02-10,7,9728,5,225,230,False
2012-02-10,8,9729,1,447,448,False
2012-02-10,9,9730,10,265,275,False
2012-02-10,10,9731,5,119,124,False
2012-02-10,11,9732,19,134,153,False
2012-02-10,12,9733,8,168,176,False
2012-02-10,13,9734,22,170,192,False
2012-02-10,14,9735,8,138,146,False
2012-02-10,15,9736,27,164,191,False
2012-02-10,16,9737,28,240,268,False
2012-02-10,17,9738,15,381,396,False
2012-02-10,18,9739,14,345,359,False
2012-02-10,19,9740,16,246,262,False
2012-02-10,20,9741,7,144,151,False
2012-02-10,21,9742,14,108,122,False
2012-02-10,22,9743,11,102,113,False
2012-02-10,23,9744,1,64,65,False
2012-02-11,0,9745,3,50,53,False
2012-02-11,1,9746,2,43,45,False
2012-02-11,2,9747,2,24,26,False
2012-02-11,3,9748,0,9,9,False
2012-02-11,4,9749,0,4,4,False
2012-02-11,5,9750,0,2,2,False
2012-02-11,6,9751,1,8,9,False
2012-02-11,7,9752,0,19,19,False
2012-02-11,8,9753,1,77,78,False
2012-02-11,9,9754,5,85,90,False
2012-02-11,10,9755,23,143,166,False
2012-02-11,11,9756,26,157,183,False
2012-02-11,12,9757,25,196,221,False
2012-02-11,13,9758,18,217,235,False
2012-02-11,14,9759,38,205,243,False
2012-02-11,15,9760,12,112,124,False
2012-02-11,16,9761,12,134,146,False
2012-02-11,17,9762,13,131,144,False
2012-02-11,18,9763,3,105,108,False
2012-02-11,19,9764,2,85,87,False
2012-02-11,20,9765,1,62,63,False
2012-02-11,21,9766,5,43,48,False
2012-02-11,22,9767,0,46,46,False
2012-02-11,23,9768,0,20,20,False
2012-02-12,0,9769,0,21,21,False
2012-02-12,1,9770,0,24,24,False
2012-02-12,2,9771,1,26,27,False
2012-02-12,3,9772,0,14,14,False
2012-02-12,4,9773,0,1,1,False
2012-02-12,5,9774,0,3,3,False
2012-02-12,6,9775,0,2,2,False
2012-02-12,7,9776,0,18,18,False
2012-02-12,8,9777,0,26,26,False
2012-02-12,9,9778,3,60,63,False
2012-02-12,10,9779,8,83,91,False
2012-02-12,11,9780,3,121,124,False
2012-02-12,12,9781,7,133,140,False
2012-02-12,13,9782,10,128,138,False
2012-02-12,14,9783,9,102,111,False
2012-02-12,15,9784,5,150,155,False
2012-02-12,16,9785,16,148,164,False
2012-02-12,17,9786,4,83,87,False
2012-02-12,18,9787,4,92,96,False
2012-02-12,19,9788,2,78,80,False
2012-02-12,20,9789,1,56,57,False
2012-02-12,21,9790,0,36,36,False
2012-02-12,22,9791,0,28,28,False
2012-02-12,23,9792,0,23,23,False
2012-02-13,0,9793,0,9,9,False
2012-02-13,1,9794,0,6,6,False
2012-02-13,2,9795,0,4,4,False
2012-02-13,3,9796,0,1,1,False
2012-02-13,4,9797,0,2,2,False
2012-02-13,5,9798,0,17,17,False
2012-02-13,6,9799,1,71,72,False
2012-02-13,7,9800,1,194,195,False
2012-02-13,8,9801,4,413,417,False
2012-02-13,9,9802,7,198,205,False
2012-02-13,10,9803,1,70,71,False
2012-02-13,11,9804,5,85,90,False
2012-02-13,12,9805,7,111,118,False
2012-02-13,13,9806,11,129,140,False
2012-02-13,14,9807,10,125,135,False
2012-02-13,15,9808,10,145,155,False
2012-02-13,16,9809,5,206,211,False
2012-02-13,17,9810,8,399,407,False
2012-02-13,18,9811,6,399,405,False
2012-02-13,19,9812,7,256,263,False
2012-02-13,20,9813,4,210,214,False
2012-02-13,21,9814,2,145,147,False
2012-02-13,22,9815,3,99,102,False
2012-02-13,23,9816,2,34,36,False
2012-02-14,0,9817,0,14,14,False
2012-02-14,1,9818,0,6,6,False
2012-02-14,2,9819,0,3,3,False
2012-02-14,3,9820,0,3,3,False
2012-02-14,4,9821,0,2,2,False
2012-02-14,5,9822,2,20,22,False
2012-02-14,6,9823,1,89,90,False
2012-02-14,7,9824,4,276,280,False
2012-02-14,8,9825,3,510,513,False
2012-02-14,9,9826,6,256,262,False
2012-02-14,10,9827,8,90,98,False
2012-02-14,11,9828,5,107,112,False
2012-02-14,12,9829,10,162,172,False
2012-02-14,13,9830,6,167,173,False
2012-02-14,14,9831,13,111,124,False
2012-02-14,15,9832,7,138,145,False
2012-02-14,16,9833,15,251,266,False
2012-02-14,17,9834,19,504,523,False
2012-02-14,18,9835,8,398,406,False
2012-02-14,19,9836,11,270,281,False
2012-02-14,20,9837,6,178,184,False
2012-02-14,21,9838,4,105,109,False
2012-02-14,22,9839,5,72,77,False
2012-02-14,23,9840,2,55,57,False
2012-02-15,0,9841,0,22,22,False
2012-02-15,1,9842,0,5,5,False
2012-02-15,2,9843,0,4,4,False
2012-02-15,3,9844,0,3,3,False
2012-02-15,4,9845,0,1,1,False
2012-02-15,5,9846,0,25,25,False
2012-02-15,6,9847,3,92,95,False
2012-02-15,7,9848,3,318,321,False
2012-02-15,8,9849,7,508,515,False
2012-02-15,9,9850,5,226,231,False
2012-02-15,10,9851,12,108,120,False
2012-02-15,11,9852,13,125,138,False
2012-02-15,12,9853,11,152,163,False
2012-02-15,13,9854,11,159,170,False
2012-02-15,14,9855,6,128,134,False
2012-02-15,15,9856,7,164,171,False
2012-02-15,16,9857,9,222,231,False
2012-02-15,17,9858,17,470,487,False
2012-02-15,18,9859,9,459,468,False
2012-02-15,19,9860,9,302,311,False
2012-02-15,20,9861,4,207,211,False
2012-02-15,21,9862,8,170,178,False
2012-02-15,22,9863,3,104,107,False
2012-02-15,23,9864,4,54,58,False
2012-02-16,0,9865,1,22,23,False
2012-02-16,1,9866,0,5,5,False
2012-02-16,2,9867,1,6,7,False
2012-02-16,3,9868,0,1,1,False
2012-02-16,4,9869,0,3,3,False
2012-02-16,5,9870,0,20,20,False
2012-02-16,6,9871,4,83,87,False
2012-02-16,7,9872,3,285,288,False
2012-02-16,8,9873,9,489,498,False
2012-02-16,9,9874,3,199,202,False
2012-02-16,10,9875,2,42,44,False
2012-02-16,11,9876,2,69,71,False
2012-02-16,12,9877,1,44,45,False
2012-02-16,13,9878,2,62,64,False
2012-02-16,14,9879,1,30,31,False
2012-02-16,15,9880,3,50,53,False
2012-02-16,16,9881,8,110,118,False
2012-02-16,17,9882,8,281,289,False
2012-02-16,18,9883,8,345,353,False
2012-02-16,19,9884,4,254,258,False
2012-02-16,20,9885,5,211,216,False
2012-02-16,21,9886,3,142,145,False
2012-02-16,22,9887,3,108,111,False
2012-02-16,23,9888,3,70,73,False
2012-02-17,0,9889,2,32,34,False
2012-02-17,1,9890,2,16,18,False
2012-02-17,2,9891,1,11,12,False
2012-02-17,3,9892,0,1,1,False
2012-02-17,4,9893,0,1,1,False
2012-02-17,5,9894,0,16,16,False
2012-02-17,6,9895,1,70,71,False
2012-02-17,7,9896,4,222,226,False
2012-02-17,8,9897,4,516,520,False
2012-02-17,9,9898,8,275,283,False
2012-02-17,10,9899,13,103,116,False
2012-02-17,11,9900,9,133,142,False
2012-02-17,12,9901,21,177,198,False
2012-02-17,13,9902,34,171,205,False
2012-02-17,14,9903,33,137,170,False
2012-02-17,15,9904,41,180,221,False
2012-02-17,16,9905,56,251,307,False
2012-02-17,17,9906,36,429,465,False
2012-02-17,18,9907,15,362,377,False
2012-02-17,19,9908,16,266,282,False
2012-02-17,20,9909,13,158,171,False
2012-02-17,21,9910,15,114,129,False
2012-02-17,22,9911,15,92,107,False
2012-02-17,23,9912,10,72,82,False
2012-02-18,0,9913,5,81,86,False
2012-02-18,1,9914,7,38,45,False
2012-02-18,2,9915,6,39,45,False
2012-02-18,3,9916,3,15,18,False
2012-02-18,4,9917,3,4,7,False
2012-02-18,5,9918,0,1,1,False
2012-02-18,6,9919,1,8,9,False
2012-02-18,7,9920,8,33,41,False
2012-02-18,8,9921,10,92,102,False
2012-02-18,9,9922,22,116,138,False
2012-02-18,10,9923,48,157,205,False
2012-02-18,11,9924,102,184,286,False
2012-02-18,12,9925,128,241,369,False
2012-02-18,13,9926,165,219,384,False
2012-02-18,14,9927,183,244,427,False
2012-02-18,15,9928,229,270,499,False
2012-02-18,16,9929,186,218,404,False
2012-02-18,17,9930,142,222,364,False
2012-02-18,18,9931,70,176,246,False
2012-02-18,19,9932,38,150,188,False
2012-02-18,20,9933,25,123,148,False
2012-02-18,21,9934,25,89,114,False
2012-02-18,22,9935,17,101,118,False
2012-02-18,23,9936,12,62,74,False
2012-02-19,0,9937,9,65,74,False
2012-02-19,1,9938,10,62,72,False
2012-02-19,2,9939,3,45,48,False
2012-02-19,3,9940,3,12,15,False
2012-02-19,4,9941,0,3,3,False
2012-02-19,5,9942,1,1,2,False
2012-02-19,6,9943,0,5,5,False
2012-02-19,7,9944,2,12,14,False
2012-02-19,8,9945,8,48,56,False
2012-02-19,9,9946,20,73,93,False
2012-02-19,10,9947,49,142,191,False
2012-02-19,11,9948,82,144,226,False
2012-02-19,12,9949,71,184,255,False
2012-02-19,13,9950,64,197,261,False
2012-02-19,14,9951,48,189,237,False
2012-02-19,15,9952,85,168,253,False
2012-02-19,16,9953,62,150,212,False
2012-02-19,17,9954,22,135,157,False
2012-02-19,18,9955,23,144,167,False
2012-02-19,19,9956,18,101,119,False
2012-02-19,20,9957,22,81,103,False
2012-02-19,21,9958,3,33,36,False
2012-02-19,22,9959,8,47,55,False
2012-02-19,23,9960,5,30,35,False
2012-02-20,0,9961,5,36,41,False
2012-02-20,1,9962,3,12,15,False
2012-02-20,2,9963,1,19,20,False
2012-02-20,3,9964,0,8,8,False
2012-02-20,4,9965,1,5,6,True
2012-02-20,5,9966,0,6,6,False
2012-02-20,6,9967,1,9,10,False
2012-02-20,7,9968,2,42,44,False
2012-02-20,8,9969,9,111,120,False
2012-02-20,9,9970,12,98,110,False
2012-02-20,10,9971,30,113,143,False
2012-02-20,11,9972,45,163,208,False
2012-02-20,12,9973,65,216,281,False
2012-02-20,13,9974,66,246,312,False
2012-02-20,14,9975,57,206,263,False
2012-02-20,15,9976,54,235,289,False
2012-02-20,16,9977,64,216,280,False
2012-02-20,17,9978,27,226,253,False
2012-02-20,18,9979,27,215,242,False
2012-02-20,19,9980,8,164,172,False
2012-02-20,20,9981,9,117,126,False
2012-02-20,21,9982,8,90,98,False
2012-02-20,22,9983,9,53,62,False
2012-02-20,23,9984,0,26,26,False
2012-02-21,0,9985,1,11,12,False
2012-02-21,1,9986,0,7,7,False
2012-02-21,2,9987,0,3,3,False
2012-02-21,3,9988,3,9,12,True
2012-02-21,4,9989,0,2,2,False
2012-02-21,5,9990,0,15,15,False
2012-02-21,6,9991,3,83,86,False
2012-02-21,7,9992,6,273,279,False
2012-02-21,8,9993,5,459,464,False
2012-02-21,9,9994,6,211,217,False
2012-02-21,10,9995,8,77,85,False
2012-02-21,11,9996,5,81,86,False
2012-02-21,12,9997,16,147,163,False
2012-02-21,13,9998,8,123,131,False
2012-02-21,14,9999,16,108,124,False
2012-02-21,15,10000,23,137,160,False
2012-02-21,16,10001,14,240,254,False
2012-02-21,17,10002,21,411,432,False
2012-02-21,18,10003,11,414,425,False
2012-02-21,19,10004,5,299,304,False
2012-02-21,20,10005,4,223,227,False
2012-02-21,21,10006,7,147,154,False
2012-02-21,22,10007,3,97,100,False
2012-02-21,23,10008,1,46,47,False
2012-02-22,0,10009,5,19,24,False
2012-02-22,1,10010,3,4,7,False
2012-02-22,2,10011,1,5,6,False
2012-02-22,3,10012,1,3,4,False
2012-02-22,4,10013,0,2,2,False
2012-02-22,5,10014,1,29,30,False
2012-02-22,6,10015,5,85,90,False
2012-02-22,7,10016,10,292,302,False
2012-02-22,8,10017,9,567,576,False
2012-02-22,9,10018,11,241,252,False
2012-02-22,10,10019,17,122,139,False
2012-02-22,11,10020,22,149,171,False
2012-02-22,12,10021,21,186,207,False
2012-02-22,13,10022,15,175,190,False
2012-02-22,14,10023,35,142,177,False
2012-02-22,15,10024,34,161,195,False
2012-02-22,16,10025,30,268,298,False
2012-02-22,17,10026,43,486,529,False
2012-02-22,18,10027,42,483,525,False
2012-02-22,19,10028,22,305,327,False
2012-02-22,20,10029,25,249,274,False
2012-02-22,21,10030,19,220,239,False
2012-02-22,22,10031,18,129,147,False
2012-02-22,23,10032,5,57,62,False
2012-02-23,0,10033,12,30,42,False
2012-02-23,1,10034,3,12,15,False
2012-02-23,2,10035,5,4,9,False
2012-02-23,3,10036,2,4,6,False
2012-02-23,4,10037,0,1,1,False
2012-02-23,5,10038,2,30,32,False
2012-02-23,6,10039,3,88,91,False
2012-02-23,7,10040,9,317,326,False
2012-02-23,8,10041,11,549,560,False
2012-02-23,9,10042,14,228,242,False
2012-02-23,10,10043,41,107,148,False
2012-02-23,11,10044,54,128,182,False
2012-02-23,12,10045,25,199,224,False
2012-02-23,13,10046,30,188,218,False
2012-02-23,14,10047,36,156,192,False
2012-02-23,15,10048,46,171,217,False
2012-02-23,16,10049,45,298,343,False
2012-02-23,17,10050,49,561,610,False
2012-02-23,18,10051,36,486,522,False
2012-02-23,19,10052,20,349,369,False
2012-02-23,20,10053,23,246,269,False
2012-02-23,21,10054,17,205,222,False
2012-02-23,22,10055,19,118,137,False
2012-02-23,23,10056,14,71,85,False
2012-02-24,0,10057,12,34,46,False
2012-02-24,1,10058,3,15,18,False
2012-02-24,2,10059,1,4,5,False
2012-02-24,3,10060,0,5,5,False
2012-02-24,4,10061,0,2,2,False
2012-02-24,5,10062,1,25,26,False
2012-02-24,6,10063,2,80,82,False
2012-02-24,7,10064,7,265,272,False
2012-02-24,8,10065,17,452,469,False
2012-02-24,9,10066,15,229,244,False
2012-02-24,10,10067,22,119,141,False
2012-02-24,11,10068,27,136,163,False
2012-02-24,12,10069,27,201,228,False
2012-02-24,13,10070,30,153,183,False
2012-02-24,14,10071,5,26,31,False
2012-02-24,15,10072,11,83,94,False
2012-02-24,16,10073,12,166,178,False
2012-02-24,17,10074,14,242,256,False
2012-02-24,18,10075,11,289,300,False
2012-02-24,19,10076,6,227,233,False
2012-02-24,20,10077,8,159,167,False
2012-02-24,21,10078,1,151,152,False
2012-02-24,22,10079,4,102,106,False
2012-02-24,23,10080,10,76,86,False
2012-02-25,0,10081,5,56,61,False
2012-02-25,1,10082,4,42,46,False
2012-02-25,2,10083,1,37,38,False
2012-02-25,3,10084,0,7,7,False
2012-02-25,4,10085,0,2,2,False
2012-02-25,5,10086,0,3,3,False
2012-02-25,6,10087,1,12,13,False
2012-02-25,7,10088,3,20,23,False
2012-02-25,8,10089,3,90,93,False
2012-02-25,9,10090,15,107,122,False
2012-02-25,10,10091,24,159,183,False
2012-02-25,11,10092,23,187,210,False
2012-02-25,12,10093,41,217,258,False
2012-02-25,13,10094,48,178,226,False
2012-02-25,14,10095,35,181,216,False
2012-02-25,15,10096,21,211,232,False
2012-02-25,16,10097,32,163,195,False
2012-02-25,17,10098,16,143,159,False
2012-02-25,18,10099,7,126,133,False
2012-02-25,19,10100,12,137,149,False
2012-02-25,20,10101,10,95,105,False
2012-02-25,21,10102,5,80,85,False
2012-02-25,22,10103,4,78,82,False
2012-02-25,23,10104,7,84,91,False
2012-02-26,0,10105,7,63,70,False
2012-02-26,1,10106,5,50,55,False
2012-02-26,2,10107,5,37,42,False
2012-02-26,3,10108,0,21,21,False
2012-02-26,4,10109,1,5,6,False
2012-02-26,5,10110,0,5,5,False
2012-02-26,6,10111,0,2,2,False
2012-02-26,7,10112,2,20,22,False
2012-02-26,8,10113,2,57,59,False
2012-02-26,9,10114,11,76,87,False
2012-02-26,10,10115,27,161,188,False
2012-02-26,11,10116,43,184,227,False
2012-02-26,12,10117,49,256,305,False
2012-02-26,13,10118,58,267,325,False
2012-02-26,14,10119,68,263,331,False
2012-02-26,15,10120,72,281,353,False
2012-02-26,16,10121,64,275,339,False
2012-02-26,17,10122,46,241,287,False
2012-02-26,18,10123,17,199,216,False
2012-02-26,19,10124,13,130,143,False
2012-02-26,20,10125,9,79,88,False
2012-02-26,21,10126,8,75,83,False
2012-02-26,22,10127,3,68,71,False
2012-02-26,23,10128,5,59,64,False
2012-02-27,0,10129,2,27,29,False
2012-02-27,1,10130,0,6,6,False
2012-02-27,2,10131,0,4,4,False
2012-02-27,3,10132,0,2,2,False
2012-02-27,4,10133,0,1,1,False
2012-02-27,5,10134,0,16,16,False
2012-02-27,6,10135,1,89,90,False
2012-02-27,7,10136,2,278,280,False
2012-02-27,8,10137,14,514,528,False
2012-02-27,9,10138,11,219,230,False
2012-02-27,10,10139,16,88,104,False
2012-02-27,11,10140,11,92,103,False
2012-02-27,12,10141,13,164,177,False
2012-02-27,13,10142,23,159,182,False
2012-02-27,14,10143,24,134,158,False
2012-02-27,15,10144,24,150,174,False
2012-02-27,16,10145,20,266,286,False
2012-02-27,17,10146,26,503,529,False
2012-02-27,18,10147,10,517,527,False
2012-02-27,19,10148,16,318,334,False
2012-02-27,20,10149,11,208,219,False
2012-02-27,21,10150,14,181,195,False
2012-02-27,22,10151,9,83,92,False
2012-02-27,23,10152,6,50,56,False
2012-02-28,0,10153,0,10,10,False
2012-02-28,1,10154,0,6,6,False
2012-02-28,2,10155,1,2,3,False
2012-02-28,3,10156,0,6,6,False
2012-02-28,4,10157,0,2,2,False
2012-02-28,5,10158,1,20,21,False
2012-02-28,6,10159,1,100,101,False
2012-02-28,7,10160,12,313,325,False
2012-02-28,8,10161,16,543,559,False
2012-02-28,9,10162,7,225,232,False
2012-02-28,10,10163,14,118,132,False
2012-02-28,11,10164,8,155,163,False
2012-02-28,12,10165,19,164,183,False
2012-02-28,13,10166,16,174,190,False
2012-02-28,14,10167,13,121,134,False
2012-02-28,15,10168,17,149,166,False
2012-02-28,16,10169,17,270,287,False
2012-02-28,17,10170,33,497,530,False
2012-02-28,18,10171,17,432,449,False
2012-02-28,19,10172,15,291,306,False
2012-02-28,20,10173,2,202,204,False
2012-02-28,21,10174,10,178,188,False
2012-02-28,22,10175,6,95,101,False
2012-02-28,23,10176,4,61,65,False
2012-02-29,0,10177,2,30,32,False
2012-02-29,1,10178,0,6,6,False
2012-02-29,2,10179,0,4,4,False
2012-02-29,3,10180,0,2,2,False
2012-02-29,4,10181,1,5,6,True
2012-02-29,5,10182,0,29,29,False
2012-02-29,6,10183,4,100,104,False
2012-02-29,7,10184,11,242,253,False
2012-02-29,8,10185,2,114,116,False
2012-02-29,9,10186,5,33,38,False
2012-02-29,10,10187,0,10,10,False
2012-02-29,11,10188,1,9,10,False
2012-02-29,12,10189,1,69,70,False
2012-02-29,13,10190,4,72,76,False
2012-02-29,14,10191,2,54,56,False
2012-02-29,15,10192,3,87,90,False
2012-02-29,16,10193,5,162,167,False
2012-02-29,17,10194,7,246,253,False
2012-02-29,18,10195,11,181,192,False
2012-02-29,19,10196,0,102,102,False
2012-02-29,20,10197,2,95,97,False
2012-02-29,21,10198,0,39,39,False
2012-02-29,22,10199,2,53,55,False
2012-02-29,23,10200,3,30,33,False
2012-03-01,0,10201,1,10,11,False
2012-03-01,1,10202,0,12,12,False
2012-03-01,2,10203,0,6,6,False
2012-03-01,3,10204,0,3,3,False
2012-03-01,4,10205,0,5,5,False
2012-03-01,5,10206,0,18,18,False
2012-03-01,6,10207,2,107,109,False
2012-03-01,7,10208,8,296,304,False
2012-03-01,8,10209,15,579,594,False
2012-03-01,9,10210,5,281,286,False
2012-03-01,10,10211,11,122,133,False
2012-03-01,11,10212,19,149,168,False
2012-03-01,12,10213,16,204,220,False
2012-03-01,13,10214,24,187,211,False
2012-03-01,14,10215,37,174,211,False
2012-03-01,15,10216,31,192,223,False
2012-03-01,16,10217,38,323,361,False
2012-03-01,17,10218,49,551,600,False
2012-03-01,18,10219,27,498,525,False
2012-03-01,19,10220,11,317,328,False
2012-03-01,20,10221,12,242,254,False
2012-03-01,21,10222,7,190,197,False
2012-03-01,22,10223,3,123,126,False
2012-03-01,23,10224,9,76,85,False
2012-03-02,0,10225,1,45,46,False
2012-03-02,1,10226,2,18,20,False
2012-03-02,2,10227,2,4,6,False
2012-03-02,3,10228,0,3,3,False
2012-03-02,4,10229,0,2,2,False
2012-03-02,5,10230,0,24,24,False
2012-03-02,6,10231,4,88,92,False
2012-03-02,7,10232,4,258,262,False
2012-03-02,8,10233,16,533,549,False
2012-03-02,9,10234,15,299,314,False
2012-03-02,10,10235,14,118,132,False
2012-03-02,11,10236,40,154,194,False
2012-03-02,12,10237,40,194,234,False
2012-03-02,13,10238,31,191,222,False
2012-03-02,14,10239,29,176,205,False
2012-03-02,15,10240,5,73,78,False
2012-03-02,16,10241,1,49,50,False
2012-03-02,17,10242,5,123,128,False
2012-03-02,18,10243,6,154,160,False
2012-03-02,19,10244,12,162,174,False
2012-03-02,20,10245,7,93,100,False
2012-03-02,21,10246,2,99,101,False
2012-03-02,22,10247,6,69,75,False
2012-03-02,23,10248,4,19,23,False
2012-03-03,0,10249,1,21,22,False
2012-03-03,1,10250,0,44,44,False
2012-03-03,2,10251,4,34,38,False
2012-03-03,3,10252,1,20,21,False
2012-03-03,4,10253,0,2,2,False
2012-03-03,5,10254,1,1,2,False
2012-03-03,6,10255,1,6,7,False
2012-03-03,7,10256,2,14,16,False
2012-03-03,8,10257,2,46,48,False
2012-03-03,9,10258,7,87,94,False
2012-03-03,10,10259,31,137,168,False
2012-03-03,11,10260,33,181,214,False
2012-03-03,12,10261,47,252,299,False
2012-03-03,13,10262,87,252,339,False
2012-03-03,14,10263,151,279,430,False
2012-03-03,15,10264,145,254,399,False
2012-03-03,16,10265,167,300,467,False
2012-03-03,17,10266,106,279,385,False
2012-03-03,18,10267,53,250,303,False
2012-03-03,19,10268,34,191,225,False
2012-03-03,20,10269,28,121,149,False
2012-03-03,21,10270,24,130,154,False
2012-03-03,22,10271,19,115,134,False
2012-03-03,23,10272,12,94,106,False
2012-03-04,0,10273,5,67,72,False
2012-03-04,1,10274,16,60,76,False
2012-03-04,2,10275,14,66,80,False
2012-03-04,3,10276,5,21,26,False
2012-03-04,4,10277,3,11,14,False
2012-03-04,5,10278,0,5,5,False
2012-03-04,6,10279,0,5,5,False
2012-03-04,7,10280,2,21,23,False
2012-03-04,8,10281,12,54,66,False
2012-03-04,9,10282,14,104,118,False
2012-03-04,10,10283,31,161,192,False
2012-03-04,11,10284,64,192,256,False
2012-03-04,12,10285,71,256,327,False
2012-03-04,13,10286,108,256,364,False
2012-03-04,14,10287,106,226,332,False
2012-03-04,15,10288,82,252,334,False
2012-03-04,16,10289,68,231,299,False
2012-03-04,17,10290,49,214,263,False
2012-03-04,18,10291,20,164,184,False
2012-03-04,19,10292,12,120,132,False
2012-03-04,20,10293,8,80,88,False
2012-03-04,21,10294,9,70,79,False
2012-03-04,22,10295,9,53,62,False
2012-03-04,23,10296,2,24,26,False
2012-03-05,0,10297,2,15,17,False
2012-03-05,1,10298,3,3,6,False
2012-03-05,2,10299,1,3,4,False
2012-03-05,3,10300,0,1,1,False
2012-03-05,4,10301,0,1,1,False
2012-03-05,5,10302,1,17,18,False
2012-03-05,6,10303,2,89,91,False
2012-03-05,7,10304,7,253,260,False
2012-03-05,8,10305,13,415,428,False
2012-03-05,9,10306,11,186,197,False
2012-03-05,10,10307,12,74,86,False
2012-03-05,11,10308,17,86,103,False
2012-03-05,12,10309,15,122,137,False
2012-03-05,13,10310,11,109,120,False
2012-03-05,14,10311,13,115,128,False
2012-03-05,15,10312,20,110,130,False
2012-03-05,16,10313,30,180,210,False
2012-03-05,17,10314,11,376,387,False
2012-03-05,18,10315,12,363,375,False
2012-03-05,19,10316,6,220,226,False
2012-03-05,20,10317,8,171,179,False
2012-03-05,21,10318,4,116,120,False
2012-03-05,22,10319,2,76,78,False
2012-03-05,23,10320,2,29,31,False
2012-03-06,0,10321,0,8,8,False
2012-03-06,1,10322,0,6,6,False
2012-03-06,2,10323,0,4,4,False
2012-03-06,3,10324,0,1,1,False
2012-03-06,4,10325,0,3,3,False
2012-03-06,5,10326,0,25,25,False
2012-03-06,6,10327,3,99,102,False
2012-03-06,7,10328,5,270,275,False
2012-03-06,8,10329,14,487,501,False
2012-03-06,9,10330,11,222,233,False
2012-03-06,10,10331,16,113,129,False
2012-03-06,11,10332,20,110,130,False
2012-03-06,12,10333,9,129,138,False
2012-03-06,13,10334,16,148,164,False
2012-03-06,14,10335,20,116,136,False
2012-03-06,15,10336,24,142,166,False
2012-03-06,16,10337,22,228,250,False
2012-03-06,17,10338,21,425,446,False
2012-03-06,18,10339,15,442,457,False
2012-03-06,19,10340,9,278,287,False
2012-03-06,20,10341,3,184,187,False
2012-03-06,21,10342,5,143,148,False
2012-03-06,22,10343,5,101,106,False
2012-03-06,23,10344,3,51,54,False
2012-03-07,0,10345,3,12,15,False
2012-03-07,1,10346,1,4,5,False
2012-03-07,2,10347,0,4,4,False
2012-03-07,3,10348,1,2,3,False
2012-03-07,4,10349,0,3,3,False
2012-03-07,5,10350,0,18,18,False
2012-03-07,6,10351,4,104,108,False
2012-03-07,7,10352,12,332,344,False
2012-03-07,8,10353,12,554,566,False
2012-03-07,9,10354,12,252,264,False
2012-03-07,10,10355,20,127,147,False
2012-03-07,11,10356,33,128,161,False
2012-03-07,12,10357,40,175,215,False
2012-03-07,13,10358,26,179,205,False
2012-03-07,14,10359,38,137,175,False
2012-03-07,15,10360,44,165,209,False
2012-03-07,16,10361,34,254,288,False
2012-03-07,17,10362,58,554,612,False
2012-03-07,18,10363,35,509,544,False
2012-03-07,19,10364,16,345,361,False
2012-03-07,20,10365,18,242,260,False
2012-03-07,21,10366,11,177,188,False
2012-03-07,22,10367,10,149,159,False
2012-03-07,23,10368,4,58,62,False
2012-03-08,0,10369,11,35,46,False
2012-03-08,1,10370,4,17,21,False
2012-03-08,2,10371,6,5,11,False
2012-03-08,3,10372,0,3,3,False
2012-03-08,4,10373,0,2,2,False
2012-03-08,5,10374,1,28,29,False
2012-03-08,6,10375,4,105,109,False
2012-03-08,7,10376,8,326,334,False
2012-03-08,8,10377,12,573,585,False
2012-03-08,9,10378,19,282,301,False
2012-03-08,10,10379,19,119,138,False
2012-03-08,11,10380,48,156,204,False
2012-03-08,12,10381,27,224,251,False
2012-03-08,13,10382,35,198,233,False
2012-03-08,14,10383,48,155,203,False
2012-03-08,15,10384,24,161,185,False
2012-03-08,16,10385,37,305,342,False
2012-03-08,17,10386,52,545,597,False
2012-03-08,18,10387,45,545,590,False
2012-03-08,19,10388,21,395,416,False
2012-03-08,20,10389,20,282,302,False
2012-03-08,21,10390,27,206,233,False
2012-03-08,22,10391,12,141,153,False
2012-03-08,23,10392,6,88,94,False
2012-03-09,0,10393,3,51,54,False
2012-03-09,1,10394,4,22,26,False
2012-03-09,2,10395,2,9,11,False
2012-03-09,3,10396,0,7,7,False
2012-03-09,4,10397,0,1,1,False
2012-03-09,5,10398,2,27,29,False
2012-03-09,6,10399,2,83,85,False
2012-03-09,7,10400,6,262,268,False
2012-03-09,8,10401,17,484,501,False
2012-03-09,9,10402,17,267,284,False
2012-03-09,10,10403,14,145,159,False
2012-03-09,11,10404,17,170,187,False
2012-03-09,12,10405,27,174,201,False
2012-03-09,13,10406,49,175,224,False
2012-03-09,14,10407,49,129,178,False
2012-03-09,15,10408,50,188,238,False
2012-03-09,16,10409,51,292,343,False
2012-03-09,17,10410,68,498,566,False
2012-03-09,18,10411,30,440,470,False
2012-03-09,19,10412,12,232,244,False
2012-03-09,20,10413,3,156,159,False
2012-03-09,21,10414,8,133,141,False
2012-03-09,22,10415,7,100,107,False
2012-03-09,23,10416,9,77,86,False
2012-03-10,0,10417,9,68,77,False
2012-03-10,1,10418,1,50,51,False
2012-03-10,2,10419,12,30,42,False
2012-03-10,3,10420,0,16,16,False
2012-03-10,4,10421,1,3,4,False
2012-03-10,5,10422,3,7,10,False
2012-03-10,6,10423,1,11,12,False
2012-03-10,7,10424,4,36,40,False
2012-03-10,8,10425,15,96,111,False
2012-03-10,9,10426,21,127,148,False
2012-03-10,10,10427,47,176,223,False
2012-03-10,11,10428,56,218,274,False
2012-03-10,12,10429,88,241,329,False
2012-03-10,13,10430,89,268,357,False
2012-03-10,14,10431,117,262,379,False
2012-03-10,15,10432,132,274,406,False
2012-03-10,16,10433,115,275,390,False
2012-03-10,17,10434,104,250,354,False
2012-03-10,18,10435,67,230,297,False
2012-03-10,19,10436,25,159,184,False
2012-03-10,20,10437,20,101,121,False
2012-03-10,21,10438,16,94,110,False
2012-03-10,22,10439,19,81,100,False
2012-03-10,23,10440,6,77,83,False
2012-03-11,0,10441,7,62,69,False
2012-03-11,1,10442,4,57,61,False
2012-03-11,2,10443,5,18,23,True
2012-03-11,3,10444,15,51,66,False
2012-03-11,4,10445,7,15,22,False
2012-03-11,5,10446,2,5,7,False
2012-03-11,6,10447,2,8,10,False
2012-03-11,7,10448,2,15,17,False
2012-03-11,8,10449,4,68,72,False
2012-03-11,9,10450,20,70,90,False
2012-03-11,10,10451,71,147,218,False
2012-03-11,11,10452,90,209,299,False
2012-03-11,12,10453,146,264,410,False
2012-03-11,13,10454,176,288,464,False
2012-03-11,14,10455,212,289,501,False
2012-03-11,15,10456,201,286,487,False
2012-03-11,16,10457,208,301,509,False
2012-03-11,17,10458,199,299,498,False
2012-03-11,18,10459,133,256,389,False
2012-03-11,19,10460,55,203,258,False
2012-03-11,20,10461,42,129,171,False
2012-03-11,21,10462,37,110,147,False
2012-03-11,22,10463,13,81,94,False
2012-03-11,23,10464,12,40,52,False
2012-03-12,0,10465,4,20,24,False
2012-03-12,1,10466,1,9,10,False
2012-03-12,2,10467,4,5,9,False
2012-03-12,3,10468,0,2,2,False
2012-03-12,4,10469,0,3,3,False
2012-03-12,5,10470,1,15,16,False
2012-03-12,6,10471,2,86,88,False
2012-03-12,7,10472,9,259,268,False
2012-03-12,8,10473,17,547,564,False
2012-03-12,9,10474,21,260,281,False
2012-03-12,10,10475,39,98,137,False
2012-03-12,11,10476,39,111,150,False
2012-03-12,12,10477,59,162,221,False
2012-03-12,13,10478,74,176,250,False
2012-03-12,14,10479,76,145,221,False
2012-03-12,15,10480,74,159,233,False
2012-03-12,16,10481,77,255,332,False
2012-03-12,17,10482,87,557,644,False
2012-03-12,18,10483,89,623,712,False
2012-03-12,19,10484,67,379,446,False
2012-03-12,20,10485,49,237,286,False
2012-03-12,21,10486,22,183,205,False
2012-03-12,22,10487,17,116,133,False
2012-03-12,23,10488,10,53,63,False
2012-03-13,0,10489,5,21,26,False
2012-03-13,1,10490,2,14,16,False
2012-03-13,2,10491,0,1,1,False
2012-03-13,3,10492,0,2,2,False
2012-03-13,4,10493,0,1,1,False
2012-03-13,5,10494,0,24,24,False
2012-03-13,6,10495,5,108,113,False
2012-03-13,7,10496,16,292,308,False
2012-03-13,8,10497,22,571,593,False
2012-03-13,9,10498,18,324,342,False
2012-03-13,10,10499,28,115,143,False
2012-03-13,11,10500,64,155,219,False
2012-03-13,12,10501,47,197,244,False
2012-03-13,13,10502,53,180,233,False
2012-03-13,14,10503,52,160,212,False
2012-03-13,15,10504,68,196,264,False
2012-03-13,16,10505,53,312,365,False
2012-03-13,17,10506,62,614,676,False
2012-03-13,18,10507,96,638,734,False
2012-03-13,19,10508,50,429,479,False
2012-03-13,20,10509,45,306,351,False
2012-03-13,21,10510,44,200,244,False
2012-03-13,22,10511,24,146,170,False
2012-03-13,23,10512,8,79,87,False
2012-03-14,0,10513,5,34,39,False
2012-03-14,1,10514,2,25,27,False
2012-03-14,2,10515,0,2,2,False
2012-03-14,3,10516,1,3,4,False
2012-03-14,4,10517,1,4,5,False
2012-03-14,5,10518,2,25,27,False
2012-03-14,6,10519,1,120,121,False
2012-03-14,7,10520,20,348,368,False
2012-03-14,8,10521,34,628,662,False
2012-03-14,9,10522,26,325,351,False
2012-03-14,10,10523,38,150,188,False
2012-03-14,11,10524,65,155,220,False
2012-03-14,12,10525,55,212,267,False
2012-03-14,13,10526,57,197,254,False
2012-03-14,14,10527,61,163,224,False
2012-03-14,15,10528,86,197,283,False
2012-03-14,16,10529,78,278,356,False
2012-03-14,17,10530,140,642,782,False
2012-03-14,18,10531,102,647,749,False
2012-03-14,19,10532,70,402,472,False
2012-03-14,20,10533,44,286,330,False
2012-03-14,21,10534,47,241,288,False
2012-03-14,22,10535,43,159,202,False
2012-03-14,23,10536,19,72,91,False
2012-03-15,0,10537,14,46,60,False
2012-03-15,1,10538,15,8,23,False
2012-03-15,2,10539,14,5,19,False
2012-03-15,3,10540,0,7,7,False
2012-03-15,4,10541,11,3,14,False
2012-03-15,5,10542,2,24,26,False
2012-03-15,6,10543,4,113,117,False
2012-03-15,7,10544,14,367,381,False
2012-03-15,8,10545,21,602,623,False
2012-03-15,9,10546,30,285,315,False
2012-03-15,10,10547,34,130,164,False
2012-03-15,11,10548,60,151,211,False
2012-03-15,12,10549,59,206,265,False
2012-03-15,13,10550,62,211,273,False
2012-03-15,14,10551,81,177,258,False
2012-03-15,15,10552,100,187,287,False
2012-03-15,16,10553,95,331,426,False
2012-03-15,17,10554,79,634,713,False
2012-03-15,18,10555,98,648,746,False
2012-03-15,19,10556,72,353,425,False
2012-03-15,20,10557,60,270,330,False
2012-03-15,21,10558,36,207,243,False
2012-03-15,22,10559,32,137,169,False
2012-03-15,23,10560,12,85,97,False
2012-03-16,0,10561,8,49,57,False
2012-03-16,1,10562,4,22,26,False
2012-03-16,2,10563,0,4,4,False
2012-03-16,3,10564,0,3,3,False
2012-03-16,4,10565,0,3,3,False
2012-03-16,5,10566,2,30,32,False
2012-03-16,6,10567,3,96,99,False
2012-03-16,7,10568,13,265,278,False
2012-03-16,8,10569,28,534,562,False
2012-03-16,9,10570,35,277,312,False
2012-03-16,10,10571,44,136,180,False
2012-03-16,11,10572,40,167,207,False
2012-03-16,12,10573,72,222,294,False
2012-03-16,13,10574,52,208,260,False
2012-03-16,14,10575,56,146,202,False
2012-03-16,15,10576,19,88,107,False
2012-03-16,16,10577,18,111,129,False
2012-03-16,17,10578,23,235,258,False
2012-03-16,18,10579,31,377,408,False
2012-03-16,19,10580,23,273,296,False
2012-03-16,20,10581,31,204,235,False
2012-03-16,21,10582,8,144,152,False
2012-03-16,22,10583,16,132,148,False
2012-03-16,23,10584,22,104,126,False
2012-03-17,0,10585,13,87,100,False
2012-03-17,1,10586,12,57,69,False
2012-03-17,2,10587,10,32,42,False
2012-03-17,3,10588,2,24,26,False
2012-03-17,4,10589,0,2,2,False
2012-03-17,5,10590,5,3,8,False
2012-03-17,6,10591,1,29,30,False
2012-03-17,7,10592,29,57,86,False
2012-03-17,8,10593,63,155,218,False
2012-03-17,9,10594,104,217,321,False
2012-03-17,10,10595,140,303,443,False
2012-03-17,11,10596,226,359,585,False
2012-03-17,12,10597,286,365,651,False
2012-03-17,13,10598,286,400,686,False
2012-03-17,14,10599,352,338,690,False
2012-03-17,15,10600,357,322,679,False
2012-03-17,16,10601,367,318,685,False
2012-03-17,17,10602,291,357,648,False
2012-03-17,18,10603,221,339,560,False
2012-03-17,19,10604,155,262,417,False
2012-03-17,20,10605,89,182,271,False
2012-03-17,21,10606,54,169,223,False
2012-03-17,22,10607,58,153,211,False
2012-03-17,23,10608,34,151,185,False
2012-03-18,0,10609,27,80,107,False
2012-03-18,1,10610,25,88,113,False
2012-03-18,2,10611,15,41,56,False
2012-03-18,3,10612,3,15,18,False
2012-03-18,4,10613,6,8,14,False
2012-03-18,5,10614,0,6,6,False
2012-03-18,6,10615,2,9,11,False
2012-03-18,7,10616,17,25,42,False
2012-03-18,8,10617,25,71,96,False
2012-03-18,9,10618,65,113,178,False
2012-03-18,10,10619,139,212,351,False
2012-03-18,11,10620,129,239,368,False
2012-03-18,12,10621,222,281,503,False
2012-03-18,13,10622,198,346,544,False
2012-03-18,14,10623,218,303,521,False
2012-03-18,15,10624,240,314,554,False
2012-03-18,16,10625,229,312,541,False
2012-03-18,17,10626,233,308,541,False
2012-03-18,18,10627,165,294,459,False
2012-03-18,19,10628,118,234,352,False
2012-03-18,20,10629,59,139,198,False
2012-03-18,21,10630,44,129,173,False
2012-03-18,22,10631,21,79,100,False
2012-03-18,23,10632,7,39,46,False
2012-03-19,0,10633,4,19,23,False
2012-03-19,1,10634,0,15,15,False
2012-03-19,2,10635,1,7,8,False
2012-03-19,3,10636,0,2,2,False
2012-03-19,4,10637,0,3,3,False
2012-03-19,5,10638,0,31,31,False
2012-03-19,6,10639,2,118,120,False
2012-03-19,7,10640,25,329,354,False
2012-03-19,8,10641,16,563,579,False
2012-03-19,9,10642,55,276,331,False
2012-03-19,10,10643,56,128,184,False
2012-03-19,11,10644,56,145,201,False
2012-03-19,12,10645,71,211,282,False
2012-03-19,13,10646,69,194,263,False
2012-03-19,14,10647,60,200,260,False
2012-03-19,15,10648,97,189,286,False
2012-03-19,16,10649,65,320,385,False
2012-03-19,17,10650,106,615,721,False
2012-03-19,18,10651,120,681,801,False
2012-03-19,19,10652,86,463,549,False
2012-03-19,20,10653,34,296,330,False
2012-03-19,21,10654,33,190,223,False
2012-03-19,22,10655,17,131,148,False
2012-03-19,23,10656,9,45,54,False
2012-03-20,0,10657,5,24,29,False
2012-03-20,1,10658,6,9,15,False
2012-03-20,2,10659,2,8,10,False
2012-03-20,3,10660,0,3,3,False
2012-03-20,4,10661,0,6,6,False
2012-03-20,5,10662,0,20,20,False
2012-03-20,6,10663,6,94,100,False
2012-03-20,7,10664,3,167,170,False
2012-03-20,8,10665,28,488,516,False
2012-03-20,9,10666,41,284,325,False
2012-03-20,10,10667,44,119,163,False
2012-03-20,11,10668,74,156,230,False
2012-03-20,12,10669,56,205,261,False
2012-03-20,13,10670,77,207,284,False
2012-03-20,14,10671,66,182,248,False
2012-03-20,15,10672,67,177,244,False
2012-03-20,16,10673,99,332,431,False
2012-03-20,17,10674,108,642,750,False
2012-03-20,18,10675,136,665,801,False
2012-03-20,19,10676,75,480,555,False
2012-03-20,20,10677,78,299,377,False
2012-03-20,21,10678,38,239,277,False
2012-03-20,22,10679,32,156,188,False
2012-03-20,23,10680,10,80,90,False
2012-03-21,0,10681,4,29,33,False
2012-03-21,1,10682,4,22,26,False
2012-03-21,2,10683,2,8,10,False
2012-03-21,3,10684,1,7,8,False
2012-03-21,4,10685,0,4,4,False
2012-03-21,5,10686,4,35,39,False
2012-03-21,6,10687,10,139,149,False
2012-03-21,7,10688,34,338,372,False
2012-03-21,8,10689,33,502,535,False
2012-03-21,9,10690,38,255,293,False
2012-03-21,10,10691,30,124,154,False
2012-03-21,11,10692,38,154,192,False
2012-03-21,12,10693,58,171,229,False
2012-03-21,13,10694,81,222,303,False
2012-03-21,14,10695,74,151,225,False
2012-03-21,15,10696,68,175,243,False
2012-03-21,16,10697,91,287,378,False
2012-03-21,17,10698,113,616,729,False
2012-03-21,18,10699,152,627,779,False
2012-03-21,19,10700,86,496,582,False
2012-03-21,20,10701,76,298,374,False
2012-03-21,21,10702,47,204,251,False
2012-03-21,22,10703,41,156,197,False
2012-03-21,23,10704,37,88,125,False
2012-03-22,0,10705,9,32,41,False
2012-03-22,1,10706,14,16,30,False
2012-03-22,2,10707,1,5,6,False
2012-03-22,3,10708,0,7,7,False
2012-03-22,4,10709,0,6,6,False
2012-03-22,5,10710,2,32,34,False
2012-03-22,6,10711,10,126,136,False
2012-03-22,7,10712,29,332,361,False
2012-03-22,8,10713,51,598,649,False
2012-03-22,9,10714,41,277,318,False
2012-03-22,10,10715,32,110,142,False
2012-03-22,11,10716,53,166,219,False
2012-03-22,12,10717,48,224,272,False
2012-03-22,13,10718,83,215,298,False
2012-03-22,14,10719,96,161,257,False
2012-03-22,15,10720,102,202,304,False
2012-03-22,16,10721,125,300,425,False
2012-03-22,17,10722,154,656,810,False
2012-03-22,18,10723,147,654,801,False
2012-03-22,19,10724,117,469,586,False
2012-03-22,20,10725,64,360,424,False
2012-03-22,21,10726,66,308,374,False
2012-03-22,22,10727,56,164,220,False
2012-03-22,23,10728,34,117,151,False
2012-03-23,0,10729,30,65,95,False
2012-03-23,1,10730,18,32,50,False
2012-03-23,2,10731,12,20,32,False
2012-03-23,3,10732,4,6,10,False
2012-03-23,4,10733,0,3,3,False
2012-03-23,5,10734,5,29,34,False
2012-03-23,6,10735,6,110,116,False
2012-03-23,7,10736,28,318,346,False
2012-03-23,8,10737,47,615,662,False
2012-03-23,9,10738,75,305,380,False
2012-03-23,10,10739,125,150,275,False
2012-03-23,11,10740,131,187,318,False
2012-03-23,12,10741,199,272,471,False
2012-03-23,13,10742,172,256,428,False
2012-03-23,14,10743,208,224,432,False
2012-03-23,15,10744,191,281,472,False
2012-03-23,16,10745,219,370,589,False
2012-03-23,17,10746,264,693,957,False
2012-03-23,18,10747,237,593,830,False
2012-03-23,19,10748,213,473,686,False
2012-03-23,20,10749,117,328,445,False
2012-03-23,21,10750,64,220,284,False
2012-03-23,22,10751,53,218,271,False
2012-03-23,23,10752,51,125,176,False
2012-03-24,0,10753,45,111,156,False
2012-03-24,1,10754,20,108,128,False
2012-03-24,2,10755,14,55,69,False
2012-03-24,3,10756,10,22,32,False
2012-03-24,4,10757,1,6,7,False
2012-03-24,5,10758,0,4,4,False
2012-03-24,6,10759,4,24,28,False
2012-03-24,7,10760,25,45,70,False
2012-03-24,8,10761,41,113,154,False
2012-03-24,9,10762,96,153,249,False
2012-03-24,10,10763,148,197,345,False
2012-03-24,11,10764,98,175,273,False
2012-03-24,12,10765,61,122,183,False
2012-03-24,13,10766,62,134,196,False
2012-03-24,14,10767,63,160,223,False
2012-03-24,15,10768,118,172,290,False
2012-03-24,16,10769,49,128,177,False
2012-03-24,17,10770,47,68,115,False
2012-03-24,18,10771,27,110,137,False
2012-03-24,19,10772,28,105,133,False
2012-03-24,20,10773,31,80,111,False
2012-03-24,21,10774,16,88,104,False
2012-03-24,22,10775,12,71,83,False
2012-03-24,23,10776,17,88,105,False
2012-03-25,0,10777,18,62,80,False
2012-03-25,1,10778,24,65,89,False
2012-03-25,2,10779,6,29,35,False
2012-03-25,3,10780,8,10,18,False
2012-03-25,4,10781,1,7,8,False
2012-03-25,5,10782,0,6,6,False
2012-03-25,6,10783,5,13,18,False
2012-03-25,7,10784,14,25,39,False
2012-03-25,8,10785,21,68,89,False
2012-03-25,9,10786,26,92,118,False
2012-03-25,10,10787,78,172,250,False
2012-03-25,11,10788,106,217,323,False
2012-03-25,12,10789,122,238,360,False
2012-03-25,13,10790,110,257,367,False
2012-03-25,14,10791,123,291,414,False
2012-03-25,15,10792,139,282,421,False
2012-03-25,16,10793,153,339,492,False
2012-03-25,17,10794,146,273,419,False
2012-03-25,18,10795,202,289,491,False
2012-03-25,19,10796,114,261,375,False
2012-03-25,20,10797,63,196,259,False
2012-03-25,21,10798,25,124,149,False
2012-03-25,22,10799,19,92,111,False
2012-03-25,23,10800,9,56,65,False
2012-03-26,0,10801,10,23,33,False
2012-03-26,1,10802,18,10,28,False
2012-03-26,2,10803,14,6,20,False
2012-03-26,3,10804,0,1,1,False
2012-03-26,4,10805,0,4,4,False
2012-03-26,5,10806,0,36,36,False
2012-03-26,6,10807,7,110,117,False
2012-03-26,7,10808,15,355,370,False
2012-03-26,8,10809,32,625,657,False
2012-03-26,9,10810,37,245,282,False
2012-03-26,10,10811,55,98,153,False
2012-03-26,11,10812,47,131,178,False
2012-03-26,12,10813,63,216,279,False
2012-03-26,13,10814,79,222,301,False
2012-03-26,14,10815,58,159,217,False
2012-03-26,15,10816,66,157,223,False
2012-03-26,16,10817,60,245,305,False
2012-03-26,17,10818,65,599,664,False
2012-03-26,18,10819,90,594,684,False
2012-03-26,19,10820,41,417,458,False
2012-03-26,20,10821,12,209,221,False
2012-03-26,21,10822,11,175,186,False
2012-03-26,22,10823,13,80,93,False
2012-03-26,23,10824,2,46,48,False
2012-03-27,0,10825,1,9,10,False
2012-03-27,1,10826,1,4,5,False
2012-03-27,2,10827,1,6,7,False
2012-03-27,3,10828,0,4,4,False
2012-03-27,4,10829,0,3,3,False
2012-03-27,5,10830,1,16,17,False
2012-03-27,6,10831,5,96,101,False
2012-03-27,7,10832,9,277,286,False
2012-03-27,8,10833,14,567,581,False
2012-03-27,9,10834,8,259,267,False
2012-03-27,10,10835,20,118,138,False
2012-03-27,11,10836,34,141,175,False
2012-03-27,12,10837,34,186,220,False
2012-03-27,13,10838,46,165,211,False
2012-03-27,14,10839,37,147,184,False
2012-03-27,15,10840,42,158,200,False
2012-03-27,16,10841,38,267,305,False
2012-03-27,17,10842,72,542,614,False
2012-03-27,18,10843,67,577,644,False
2012-03-27,19,10844,40,377,417,False
2012-03-27,20,10845,28,266,294,False
2012-03-27,21,10846,21,200,221,False
2012-03-27,22,10847,7,127,134,False
2012-03-27,23,10848,5,59,64,False
2012-03-28,0,10849,1,29,30,False
2012-03-28,1,10850,0,8,8,False
2012-03-28,2,10851,0,3,3,False
2012-03-28,3,10852,1,4,5,False
2012-03-28,4,10853,1,0,1,False
2012-03-28,5,10854,2,38,40,False
2012-03-28,6,10855,4,111,115,False
2012-03-28,7,10856,10,348,358,False
2012-03-28,8,10857,19,639,658,False
2012-03-28,9,10858,16,298,314,False
2012-03-28,10,10859,33,140,173,False
2012-03-28,11,10860,54,168,222,False
2012-03-28,12,10861,50,218,268,False
2012-03-28,13,10862,60,213,273,False
2012-03-28,14,10863,52,169,221,False
2012-03-28,15,10864,47,152,199,False
2012-03-28,16,10865,51,170,221,False
2012-03-28,17,10866,72,532,604,False
2012-03-28,18,10867,61,580,641,False
2012-03-28,19,10868,41,415,456,False
2012-03-28,20,10869,38,324,362,False
2012-03-28,21,10870,28,233,261,False
2012-03-28,22,10871,21,151,172,False
2012-03-28,23,10872,12,81,93,False
2012-03-29,0,10873,10,38,48,False
2012-03-29,1,10874,15,18,33,False
2012-03-29,2,10875,0,6,6,False
2012-03-29,3,10876,1,4,5,False
2012-03-29,4,10877,1,8,9,False
2012-03-29,5,10878,2,30,32,False
2012-03-29,6,10879,3,114,117,False
2012-03-29,7,10880,14,353,367,False
2012-03-29,8,10881,26,628,654,False
2012-03-29,9,10882,22,299,321,False
2012-03-29,10,10883,42,124,166,False
2012-03-29,11,10884,54,166,220,False
2012-03-29,12,10885,64,228,292,False
2012-03-29,13,10886,50,223,273,False
2012-03-29,14,10887,63,175,238,False
2012-03-29,15,10888,109,198,307,False
2012-03-29,16,10889,67,321,388,False
2012-03-29,17,10890,83,620,703,False
2012-03-29,18,10891,83,598,681,False
2012-03-29,19,10892,47,421,468,False
2012-03-29,20,10893,34,301,335,False
2012-03-29,21,10894,10,214,224,False
2012-03-29,22,10895,17,135,152,False
2012-03-29,23,10896,17,77,94,False
2012-03-30,0,10897,10,49,59,False
2012-03-30,1,10898,6,21,27,False
2012-03-30,2,10899,1,6,7,False
2012-03-30,3,10900,0,7,7,False
2012-03-30,4,10901,1,1,2,False
2012-03-30,5,10902,0,26,26,False
2012-03-30,6,10903,5,81,86,False
2012-03-30,7,10904,9,280,289,False
2012-03-30,8,10905,38,555,593,False
2012-03-30,9,10906,29,292,321,False
2012-03-30,10,10907,50,137,187,False
2012-03-30,11,10908,48,153,201,False
2012-03-30,12,10909,62,208,270,False
2012-03-30,13,10910,44,198,242,False
2012-03-30,14,10911,56,173,229,False
2012-03-30,15,10912,73,207,280,False
2012-03-30,16,10913,75,292,367,False
2012-03-30,17,10914,93,513,606,False
2012-03-30,18,10915,68,492,560,False
2012-03-30,19,10916,42,353,395,False
2012-03-30,20,10917,17,192,209,False
2012-03-30,21,10918,30,190,220,False
2012-03-30,22,10919,23,130,153,False
2012-03-30,23,10920,16,107,123,False
2012-03-31,0,10921,12,80,92,False
2012-03-31,1,10922,17,65,82,False
2012-03-31,2,10923,14,55,69,False
2012-03-31,3,10924,10,21,31,False
2012-03-31,4,10925,4,4,8,False
2012-03-31,5,10926,0,5,5,False
2012-03-31,6,10927,7,16,23,False
2012-03-31,7,10928,5,39,44,False
2012-03-31,8,10929,19,126,145,False
2012-03-31,9,10930,62,161,223,False
2012-03-31,10,10931,108,205,313,False
2012-03-31,11,10932,184,279,463,False
2012-03-31,12,10933,263,358,621,False
2012-03-31,13,10934,265,373,638,False
2012-03-31,14,10935,240,311,551,False
2012-03-31,15,10936,275,330,605,False
2012-03-31,16,10937,243,292,535,False
2012-03-31,17,10938,238,305,543,False
2012-03-31,18,10939,102,239,341,False
2012-03-31,19,10940,93,191,284,False
2012-03-31,20,10941,52,156,208,False
2012-03-31,21,10942,36,107,143,False
2012-03-31,22,10943,40,116,156,False
2012-03-31,23,10944,12,100,112,False
2012-04-01,0,10945,8,59,67,False
2012-04-01,1,10946,13,49,62,False
2012-04-01,2,10947,20,61,81,False
2012-04-01,3,10948,4,21,25,False
2012-04-01,4,10949,3,9,12,False
2012-04-01,5,10950,8,10,18,False
2012-04-01,6,10951,9,88,97,False
2012-04-01,7,10952,29,55,84,False
2012-04-01,8,10953,37,88,125,False
2012-04-01,9,10954,102,173,275,False
2012-04-01,10,10955,132,228,360,False
2012-04-01,11,10956,180,271,451,False
2012-04-01,12,10957,187,258,445,False
2012-04-01,13,10958,190,274,464,False
2012-04-01,14,10959,283,278,561,False
2012-04-01,15,10960,295,278,573,False
2012-04-01,16,10961,236,275,511,False
2012-04-01,17,10962,232,323,555,False
2012-04-01,18,10963,153,279,432,False
2012-04-01,19,10964,110,236,346,False
2012-04-01,20,10965,66,166,232,False
2012-04-01,21,10966,33,101,134,False
2012-04-01,22,10967,7,61,68,False
2012-04-01,23,10968,10,53,63,False
2012-04-02,0,10969,6,11,17,False
2012-04-02,1,10970,0,5,5,False
2012-04-02,2,10971,2,3,5,False
2012-04-02,3,10972,3,9,12,True
2012-04-02,4,10973,2,2,4,False
2012-04-02,5,10974,2,22,24,False
2012-04-02,6,10975,6,104,110,False
2012-04-02,7,10976,12,294,306,False
2012-04-02,8,10977,36,553,589,False
2012-04-02,9,10978,52,265,317,False
2012-04-02,10,10979,85,119,204,False
2012-04-02,11,10980,81,128,209,False
2012-04-02,12,10981,100,181,281,False
2012-04-02,13,10982,97,184,281,False
2012-04-02,14,10983,127,141,268,False
2012-04-02,15,10984,132,192,324,False
2012-04-02,16,10985,104,291,395,False
2012-04-02,17,10986,128,601,729,False
2012-04-02,18,10987,75,543,618,False
2012-04-02,19,10988,66,428,494,False
2012-04-02,20,10989,48,281,329,False
2012-04-02,21,10990,24,214,238,False
2012-04-02,22,10991,17,106,123,False
2012-04-02,23,10992,6,60,66,False
2012-04-03,0,10993,1,32,33,False
2012-04-03,1,10994,0,11,11,False
2012-04-03,2,10995,0,5,5,False
2012-04-03,3,10996,0,3,3,False
2012-04-03,4,10997,0,1,1,False
2012-04-03,5,10998,2,25,27,False
2012-04-03,6,10999,2,98,100,False
2012-04-03,7,11000,14,327,341,False
2012-04-03,8,11001,27,577,604,False
2012-04-03,9,11002,54,354,408,False
2012-04-03,10,11003,77,142,219,False
2012-04-03,11,11004,91,167,258,False
2012-04-03,12,11005,101,230,331,False
2012-04-03,13,11006,120,225,345,False
2012-04-03,14,11007,120,191,311,False
2012-04-03,15,11008,109,207,316,False
2012-04-03,16,11009,145,340,485,False
2012-04-03,17,11010,123,634,757,False
2012-04-03,18,11011,139,661,800,False
2012-04-03,19,11012,98,460,558,False
2012-04-03,20,11013,54,325,379,False
2012-04-03,21,11014,33,210,243,False
2012-04-03,22,11015,25,133,158,False
2012-04-03,23,11016,13,66,79,False
2012-04-04,0,11017,18,23,41,False
2012-04-04,1,11018,0,11,11,False
2012-04-04,2,11019,0,5,5,False
2012-04-04,3,11020,0,3,3,False
2012-04-04,4,11021,0,1,1,False
2012-04-04,5,11022,0,27,27,False
2012-04-04,6,11023,6,120,126,False
2012-04-04,7,11024,12,354,366,False
2012-04-04,8,11025,31,653,684,False
2012-04-04,9,11026,47,316,363,False
2012-04-04,10,11027,68,99,167,False
2012-04-04,11,11028,61,152,213,False
2012-04-04,12,11029,73,210,283,False
2012-04-04,13,11030,70,181,251,False
2012-04-04,14,11031,82,176,258,False
2012-04-04,15,11032,86,182,268,False
2012-04-04,16,11033,86,304,390,False
2012-04-04,17,11034,99,645,744,False
2012-04-04,18,11035,113,646,759,False
2012-04-04,19,11036,75,419,494,False
2012-04-04,20,11037,39,333,372,False
2012-04-04,21,11038,43,255,298,False
2012-04-04,22,11039,30,151,181,False
2012-04-04,23,11040,19,112,131,False
2012-04-05,0,11041,12,33,45,False
2012-04-05,1,11042,4,9,13,False
2012-04-05,2,11043,7,11,18,False
2012-04-05,3,11044,0,5,5,False
2012-04-05,4,11045,0,1,1,False
2012-04-05,5,11046,1,28,29,False
2012-04-05,6,11047,8,118,126,False
2012-04-05,7,11048,15,339,354,False
2012-04-05,8,11049,28,610,638,False
2012-04-05,9,11050,61,290,351,False
2012-04-05,10,11051,88,158,246,False
2012-04-05,11,11052,109,159,268,False
2012-04-05,12,11053,66,210,276,False
2012-04-05,13,11054,89,202,291,False
2012-04-05,14,11055,143,144,287,False
2012-04-05,15,11056,98,171,269,False
2012-04-05,16,11057,84,318,402,False
2012-04-05,17,11058,145,677,822,False
2012-04-05,18,11059,80,618,698,False
2012-04-05,19,11060,64,423,487,False
2012-04-05,20,11061,33,279,312,False
2012-04-05,21,11062,25,209,234,False
2012-04-05,22,11063,20,129,149,False
2012-04-05,23,11064,12,124,136,False
2012-04-06,0,11065,12,49,61,False
2012-04-06,1,11066,10,28,38,False
2012-04-06,2,11067,6,5,11,False
2012-04-06,3,11068,3,5,8,False
2012-04-06,4,11069,2,3,5,False
2012-04-06,5,11070,0,23,23,False
2012-04-06,6,11071,0,80,80,False
2012-04-06,7,11072,15,231,246,False
2012-04-06,8,11073,19,489,508,False
2012-04-06,9,11074,58,318,376,False
2012-04-06,10,11075,81,157,238,False
2012-04-06,11,11076,112,179,291,False
2012-04-06,12,11077,113,224,337,False
2012-04-06,13,11078,173,238,411,False
2012-04-06,14,11079,240,250,490,False
2012-04-06,15,11080,218,319,537,False
2012-04-06,16,11081,184,352,536,False
2012-04-06,17,11082,172,483,655,False
2012-04-06,18,11083,104,380,484,False
2012-04-06,19,11084,115,297,412,False
2012-04-06,20,11085,61,191,252,False
2012-04-06,21,11086,54,136,190,False
2012-04-06,22,11087,34,124,158,False
2012-04-06,23,11088,21,92,113,False
2012-04-07,0,11089,9,85,94,False
2012-04-07,1,11090,9,60,69,False
2012-04-07,2,11091,11,25,36,False
2012-04-07,3,11092,7,21,28,False
2012-04-07,4,11093,3,4,7,False
2012-04-07,5,11094,0,2,2,False
2012-04-07,6,11095,1,18,19,False
2012-04-07,7,11096,14,40,54,False
2012-04-07,8,11097,29,94,123,False
2012-04-07,9,11098,103,173,276,False
2012-04-07,10,11099,187,176,363,False
2012-04-07,11,11100,251,244,495,False
2012-04-07,12,11101,320,270,590,False
2012-04-07,13,11102,355,288,643,False
2012-04-07,14,11103,326,252,578,False
2012-04-07,15,11104,321,305,626,False
2012-04-07,16,11105,354,261,615,False
2012-04-07,17,11106,299,268,567,False
2012-04-07,18,11107,227,290,517,False
2012-04-07,19,11108,170,243,413,False
2012-04-07,20,11109,73,135,208,False
2012-04-07,21,11110,75,159,234,False
2012-04-07,22,11111,76,106,182,False
2012-04-07,23,11112,32,86,118,False
2012-04-08,0,11113,21,64,85,False
2012-04-08,1,11114,14,50,64,False
2012-04-08,2,11115,7,25,32,False
2012-04-08,3,11116,8,18,26,False
2012-04-08,4,11117,0,7,7,False
2012-04-08,5,11118,4,8,12,False
2012-04-08,6,11119,7,21,28,False
2012-04-08,7,11120,12,25,37,False
2012-04-08,8,11121,19,65,84,False
2012-04-08,9,11122,71,108,179,False
2012-04-08,10,11123,113,186,299,False
2012-04-08,11,11124,195,209,404,False
2012-04-08,12,11125,198,259,457,False
2012-04-08,13,11126,229,254,483,False
2012-04-08,14,11127,254,249,503,False
2012-04-08,15,11128,260,226,486,False
2012-04-08,16,11129,232,244,476,False
2012-04-08,17,11130,185,226,411,False
2012-04-08,18,11131,151,159,310,False
2012-04-08,19,11132,89,187,276,False
2012-04-08,20,11133,65,146,211,False
2012-04-08,21,11134,53,77,130,False
2012-04-08,22,11135,33,85,118,False
2012-04-08,23,11136,10,41,51,False
2012-04-09,0,11137,8,29,37,False
2012-04-09,1,11138,4,12,16,False
2012-04-09,2,11139,2,4,6,False
2012-04-09,3,11140,0,3,3,False
2012-04-09,4,11141,2,3,5,False
2012-04-09,5,11142,2,30,32,False
2012-04-09,6,11143,3,108,111,False
2012-04-09,7,11144,11,320,331,False
2012-04-09,8,11145,22,595,617,False
2012-04-09,9,11146,50,236,286,False
2012-04-09,10,11147,65,113,178,False
2012-04-09,11,11148,96,127,223,False
2012-04-09,12,11149,94,186,280,False
2012-04-09,13,11150,108,173,281,False
2012-04-09,14,11151,66,152,218,False
2012-04-09,15,11152,82,173,255,False
2012-04-09,16,11153,81,310,391,False
2012-04-09,17,11154,67,565,632,False
2012-04-09,18,11155,60,586,646,False
2012-04-09,19,11156,35,386,421,False
2012-04-09,20,11157,21,255,276,False
2012-04-09,21,11158,14,151,165,False
2012-04-09,22,11159,6,102,108,False
2012-04-09,23,11160,6,61,67,False
2012-04-10,0,11161,3,23,26,False
2012-04-10,1,11162,0,9,9,False
2012-04-10,2,11163,0,2,2,False
2012-04-10,3,11164,0,2,2,False
2012-04-10,4,11165,0,2,2,False
2012-04-10,5,11166,0,24,24,False
2012-04-10,6,11167,3,100,103,False
2012-04-10,7,11168,16,368,384,False
2012-04-10,8,11169,22,670,692,False
2012-04-10,9,11170,16,303,319,False
2012-04-10,10,11171,49,132,181,False
2012-04-10,11,11172,78,161,239,False
2012-04-10,12,11173,75,184,259,False
2012-04-10,13,11174,81,202,283,False
2012-04-10,14,11175,75,149,224,False
2012-04-10,15,11176,46,157,203,False
2012-04-10,16,11177,66,296,362,False
2012-04-10,17,11178,88,656,744,False
2012-04-10,18,11179,78,626,704,False
2012-04-10,19,11180,51,428,479,False
2012-04-10,20,11181,34,248,282,False
2012-04-10,21,11182,15,191,206,False
2012-04-10,22,11183,9,118,127,False
2012-04-10,23,11184,14,48,62,False
2012-04-11,0,11185,8,22,30,False
2012-04-11,1,11186,3,9,12,False
2012-04-11,2,11187,0,2,2,False
2012-04-11,3,11188,0,2,2,False
2012-04-11,4,11189,1,5,6,True
2012-04-11,5,11190,1,26,27,False
2012-04-11,6,11191,3,103,106,False
2012-04-11,7,11192,18,303,321,False
2012-04-11,8,11193,14,581,595,False
2012-04-11,9,11194,20,282,302,False
2012-04-11,10,11195,26,127,153,False
2012-04-11,11,11196,38,142,180,False
2012-04-11,12,11197,35,147,182,False
2012-04-11,13,11198,16,147,163,False
2012-04-11,14,11199,34,101,135,False
2012-04-11,15,11200,50,152,202,False
2012-04-11,16,11201,51,256,307,False
2012-04-11,17,11202,52,527,579,False
2012-04-11,18,11203,39,546,585,False
2012-04-11,19,11204,28,356,384,False
2012-04-11,20,11205,22,213,235,False
2012-04-11,21,11206,11,154,165,False
2012-04-11,22,11207,4,130,134,False
2012-04-11,23,11208,9,52,61,False
2012-04-12,0,11209,1,22,23,False
2012-04-12,1,11210,2,7,9,False
2012-04-12,2,11211,0,4,4,False
2012-04-12,3,11212,2,3,5,False
2012-04-12,4,11213,0,1,1,False
2012-04-12,5,11214,0,21,21,False
2012-04-12,6,11215,2,94,96,False
2012-04-12,7,11216,12,294,306,False
2012-04-12,8,11217,20,604,624,False
2012-04-12,9,11218,16,271,287,False
2012-04-12,10,11219,38,103,141,False
2012-04-12,11,11220,50,174,224,False
2012-04-12,12,11221,60,199,259,False
2012-04-12,13,11222,55,148,203,False
2012-04-12,14,11223,74,150,224,False
2012-04-12,15,11224,42,169,211,False
2012-04-12,16,11225,54,299,353,False
2012-04-12,17,11226,60,596,656,False
2012-04-12,18,11227,63,547,610,False
2012-04-12,19,11228,50,383,433,False
2012-04-12,20,11229,26,254,280,False
2012-04-12,21,11230,13,174,187,False
2012-04-12,22,11231,15,143,158,False
2012-04-12,23,11232,8,86,94,False
2012-04-13,0,11233,14,41,55,False
2012-04-13,1,11234,2,28,30,False
2012-04-13,2,11235,6,5,11,False
2012-04-13,3,11236,3,8,11,False
2012-04-13,4,11237,1,4,5,False
2012-04-13,5,11238,2,19,21,False
2012-04-13,6,11239,0,84,84,False
2012-04-13,7,11240,13,283,296,False
2012-04-13,8,11241,24,539,563,False
2012-04-13,9,11242,36,294,330,False
2012-04-13,10,11243,59,133,192,False
2012-04-13,11,11244,75,158,233,False
2012-04-13,12,11245,104,218,322,False
2012-04-13,13,11246,112,246,358,False
2012-04-13,14,11247,125,223,348,False
2012-04-13,15,11248,115,237,352,False
2012-04-13,16,11249,113,350,463,False
2012-04-13,17,11250,117,621,738,False
2012-04-13,18,11251,107,564,671,False
2012-04-13,19,11252,75,352,427,False
2012-04-13,20,11253,44,242,286,False
2012-04-13,21,11254,36,153,189,False
2012-04-13,22,11255,34,181,215,False
2012-04-13,23,11256,35,163,198,False
2012-04-14,0,11257,11,85,96,False
2012-04-14,1,11258,10,60,70,False
2012-04-14,2,11259,3,53,56,False
2012-04-14,3,11260,6,26,32,False
2012-04-14,4,11261,5,9,14,False
2012-04-14,5,11262,2,5,7,False
2012-04-14,6,11263,2,19,21,False
2012-04-14,7,11264,8,56,64,False
2012-04-14,8,11265,24,136,160,False
2012-04-14,9,11266,59,206,265,False
2012-04-14,10,11267,139,267,406,False
2012-04-14,11,11268,207,357,564,False
2012-04-14,12,11269,274,404,678,False
2012-04-14,13,11270,308,370,678,False
2012-04-14,14,11271,288,372,660,False
2012-04-14,15,11272,311,347,658,False
2012-04-14,16,11273,253,329,582,False
2012-04-14,17,11274,251,309,560,False
2012-04-14,18,11275,197,284,481,False
2012-04-14,19,11276,163,296,459,False
2012-04-14,20,11277,112,209,321,False
2012-04-14,21,11278,53,167,220,False
2012-04-14,22,11279,64,148,212,False
2012-04-14,23,11280,45,151,196,False
2012-04-15,0,11281,30,94,124,False
2012-04-15,1,11282,17,89,106,False
2012-04-15,2,11283,20,54,74,False
2012-04-15,3,11284,18,27,45,False
2012-04-15,4,11285,2,10,12,False
2012-04-15,5,11286,4,6,10,False
2012-04-15,6,11287,5,11,16,False
2012-04-15,7,11288,16,30,46,False
2012-04-15,8,11289,33,64,97,False
2012-04-15,9,11290,97,154,251,False
2012-04-15,10,11291,186,235,421,False
2012-04-15,11,11292,227,301,528,False
2012-04-15,12,11293,275,360,635,False
2012-04-15,13,11294,298,383,681,False
2012-04-15,14,11295,282,346,628,False
2012-04-15,15,11296,266,351,617,False
2012-04-15,16,11297,286,330,616,False
2012-04-15,17,11298,262,361,623,False
2012-04-15,18,11299,184,295,479,False
2012-04-15,19,11300,114,265,379,False
2012-04-15,20,11301,86,205,291,False
2012-04-15,21,11302,76,153,229,False
2012-04-15,22,11303,37,97,134,False
2012-04-15,23,11304,25,65,90,False
2012-04-16,0,11305,15,26,41,False
2012-04-16,1,11306,7,21,28,False
2012-04-16,2,11307,5,9,14,False
2012-04-16,3,11308,3,5,8,False
2012-04-16,4,11309,0,6,6,False
2012-04-16,5,11310,4,34,38,False
2012-04-16,6,11311,10,123,133,False
2012-04-16,7,11312,20,367,387,False
2012-04-16,8,11313,48,549,597,False
2012-04-16,9,11314,59,238,297,False
2012-04-16,10,11315,75,149,224,False
2012-04-16,11,11316,115,136,251,False
2012-04-16,12,11317,75,196,271,False
2012-04-16,13,11318,79,184,263,False
2012-04-16,14,11319,105,183,288,False
2012-04-16,15,11320,81,194,275,False
2012-04-16,16,11321,92,266,358,False
2012-04-16,17,11322,111,601,712,False
2012-04-16,18,11323,87,589,676,False
2012-04-16,19,11324,61,461,522,False
2012-04-16,20,11325,48,327,375,False
2012-04-16,21,11326,39,232,271,False
2012-04-16,22,11327,35,179,214,False
2012-04-16,23,11328,24,97,121,False
2012-04-17,0,11329,10,33,43,False
2012-04-17,1,11330,6,5,11,False
2012-04-17,2,11331,1,3,4,False
2012-04-17,3,11332,0,6,6,False
2012-04-17,4,11333,3,6,9,False
2012-04-17,5,11334,1,29,30,False
2012-04-17,6,11335,8,136,144,False
2012-04-17,7,11336,18,443,461,False
2012-04-17,8,11337,42,631,673,False
2012-04-17,9,11338,71,329,400,False
2012-04-17,10,11339,52,165,217,False
2012-04-17,11,11340,65,174,239,False
2012-04-17,12,11341,65,179,244,False
2012-04-17,13,11342,52,187,239,False
2012-04-17,14,11343,59,198,257,False
2012-04-17,15,11344,91,217,308,False
2012-04-17,16,11345,50,320,370,False
2012-04-17,17,11346,108,673,781,False
2012-04-17,18,11347,105,670,775,False
2012-04-17,19,11348,73,464,537,False
2012-04-17,20,11349,44,358,402,False
2012-04-17,21,11350,37,260,297,False
2012-04-17,22,11351,18,144,162,False
2012-04-17,23,11352,10,72,82,False
2012-04-18,0,11353,3,35,38,False
2012-04-18,1,11354,1,13,14,False
2012-04-18,2,11355,1,8,9,False
2012-04-18,3,11356,0,6,6,False
2012-04-18,4,11357,0,7,7,False
2012-04-18,5,11358,0,34,34,False
2012-04-18,6,11359,6,128,134,False
2012-04-18,7,11360,10,408,418,False
2012-04-18,8,11361,25,551,576,False
2012-04-18,9,11362,20,245,265,False
2012-04-18,10,11363,31,116,147,False
2012-04-18,11,11364,14,105,119,False
2012-04-18,12,11365,15,95,110,False
2012-04-18,13,11366,13,51,64,False
2012-04-18,14,11367,8,43,51,False
2012-04-18,15,11368,10,88,98,False
2012-04-18,16,11369,36,199,235,False
2012-04-18,17,11370,46,442,488,False
2012-04-18,18,11371,27,478,505,False
2012-04-18,19,11372,26,342,368,False
2012-04-18,20,11373,8,252,260,False
2012-04-18,21,11374,24,165,189,False
2012-04-18,22,11375,9,153,162,False
2012-04-18,23,11376,14,56,70,False
2012-04-19,0,11377,5,20,25,False
2012-04-19,1,11378,2,11,13,False
2012-04-19,2,11379,2,4,6,False
2012-04-19,3,11380,1,3,4,False
2012-04-19,4,11381,0,4,4,False
2012-04-19,5,11382,0,30,30,False
2012-04-19,6,11383,4,116,120,False
2012-04-19,7,11384,15,391,406,False
2012-04-19,8,11385,26,651,677,False
2012-04-19,9,11386,31,270,301,False
2012-04-19,10,11387,46,143,189,False
2012-04-19,11,11388,46,183,229,False
2012-04-19,12,11389,51,213,264,False
2012-04-19,13,11390,52,186,238,False
2012-04-19,14,11391,54,183,237,False
2012-04-19,15,11392,66,196,262,False
2012-04-19,16,11393,63,324,387,False
2012-04-19,17,11394,85,663,748,False
2012-04-19,18,11395,99,677,776,False
2012-04-19,19,11396,70,516,586,False
2012-04-19,20,11397,52,352,404,False
2012-04-19,21,11398,27,240,267,False
2012-04-19,22,11399,29,219,248,False
2012-04-19,23,11400,20,124,144,False
2012-04-20,0,11401,5,59,64,False
2012-04-20,1,11402,3,22,25,False
2012-04-20,2,11403,3,18,21,False
2012-04-20,3,11404,1,9,10,False
2012-04-20,4,11405,0,3,3,False
2012-04-20,5,11406,1,24,25,False
2012-04-20,6,11407,8,105,113,False
2012-04-20,7,11408,9,350,359,False
2012-04-20,8,11409,32,668,700,False
2012-04-20,9,11410,30,329,359,False
2012-04-20,10,11411,67,170,237,False
2012-04-20,11,11412,64,190,254,False
2012-04-20,12,11413,102,260,362,False
2012-04-20,13,11414,105,276,381,False
2012-04-20,14,11415,156,238,394,False
2012-04-20,15,11416,145,262,407,False
2012-04-20,16,11417,151,429,580,False
2012-04-20,17,11418,122,697,819,False
2012-04-20,18,11419,110,558,668,False
2012-04-20,19,11420,82,410,492,False
2012-04-20,20,11421,52,289,341,False
2012-04-20,21,11422,35,252,287,False
2012-04-20,22,11423,26,176,202,False
2012-04-20,23,11424,31,156,187,False
2012-04-21,0,11425,31,111,142,False
2012-04-21,1,11426,24,64,88,False
2012-04-21,2,11427,12,69,81,False
2012-04-21,3,11428,4,25,29,False
2012-04-21,4,11429,0,9,9,False
2012-04-21,5,11430,0,1,1,False
2012-04-21,6,11431,10,21,31,False
2012-04-21,7,11432,21,55,76,False
2012-04-21,8,11433,52,149,201,False
2012-04-21,9,11434,115,216,331,False
2012-04-21,10,11435,183,299,482,False
2012-04-21,11,11436,260,348,608,False
2012-04-21,12,11437,262,378,640,False
2012-04-21,13,11438,291,358,649,False
2012-04-21,14,11439,278,331,609,False
2012-04-21,15,11440,267,361,628,False
2012-04-21,16,11441,267,372,639,False
2012-04-21,17,11442,259,309,568,False
2012-04-21,18,11443,133,283,416,False
2012-04-21,19,11444,9,45,54,False
2012-04-21,20,11445,5,34,39,False
2012-04-21,21,11446,20,82,102,False
2012-04-21,22,11447,20,90,110,False
2012-04-21,23,11448,18,73,91,False
2012-04-22,0,11449,32,85,117,False
2012-04-22,1,11450,10,63,73,False
2012-04-22,2,11451,7,49,56,False
2012-04-22,3,11452,7,33,40,False
2012-04-22,4,11453,0,7,7,False
2012-04-22,5,11454,0,6,6,False
2012-04-22,6,11455,6,6,12,False
2012-04-22,7,11456,2,22,24,False
2012-04-22,8,11457,8,43,51,False
2012-04-22,9,11458,8,71,79,False
2012-04-22,10,11459,11,57,68,False
2012-04-22,11,11460,7,70,77,False
2012-04-22,12,11461,5,56,61,False
2012-04-22,13,11462,5,47,52,False
2012-04-22,14,11463,3,50,53,False
2012-04-22,15,11464,0,38,38,False
2012-04-22,16,11465,4,32,36,False
2012-04-22,17,11466,2,25,27,False
2012-04-22,18,11467,1,38,39,False
2012-04-22,19,11468,1,34,35,False
2012-04-22,20,11469,1,34,35,False
2012-04-22,21,11470,0,11,11,False
2012-04-22,22,11471,0,13,13,False
2012-04-22,23,11472,0,17,17,False
2012-04-23,0,11473,0,6,6,False
2012-04-23,1,11474,1,1,2,False
2012-04-23,2,11475,1,3,4,False
2012-04-23,3,11476,0,1,1,False
2012-04-23,4,11477,0,3,3,False
2012-04-23,5,11478,0,14,14,False
2012-04-23,6,11479,2,43,45,False
2012-04-23,7,11480,1,206,207,False
2012-04-23,8,11481,11,471,482,False
2012-04-23,9,11482,17,255,272,False
2012-04-23,10,11483,12,88,100,False
2012-04-23,11,11484,10,91,101,False
2012-04-23,12,11485,12,117,129,False
2012-04-23,13,11486,9,98,107,False
2012-04-23,14,11487,12,102,114,False
2012-04-23,15,11488,11,101,112,False
2012-04-23,16,11489,10,93,103,False
2012-04-23,17,11490,13,219,232,False
2012-04-23,18,11491,10,369,379,False
2012-04-23,19,11492,11,287,298,False
2012-04-23,20,11493,17,186,203,False
2012-04-23,21,11494,7,145,152,False
2012-04-23,22,11495,18,71,89,False
2012-04-23,23,11496,10,49,59,False
2012-04-24,0,11497,0,13,13,False
2012-04-24,1,11498,1,6,7,False
2012-04-24,2,11499,0,3,3,False
2012-04-24,3,11500,0,2,2,False
2012-04-24,4,11501,0,3,3,False
2012-04-24,5,11502,0,22,22,False
2012-04-24,6,11503,3,117,120,False
2012-04-24,7,11504,3,387,390,False
2012-04-24,8,11505,12,599,611,False
2012-04-24,9,11506,6,302,308,False
2012-04-24,10,11507,33,129,162,False
2012-04-24,11,11508,27,157,184,False
2012-04-24,12,11509,36,188,224,False
2012-04-24,13,11510,35,189,224,False
2012-04-24,14,11511,50,166,216,False
2012-04-24,15,11512,60,176,236,False
2012-04-24,16,11513,54,308,362,False
2012-04-24,17,11514,72,619,691,False
2012-04-24,18,11515,52,580,632,False
2012-04-24,19,11516,33,449,482,False
2012-04-24,20,11517,16,269,285,False
2012-04-24,21,11518,13,213,226,False
2012-04-24,22,11519,8,149,157,False
2012-04-24,23,11520,4,69,73,False
2012-04-25,0,11521,13,23,36,False
2012-04-25,1,11522,8,17,25,False
2012-04-25,2,11523,1,6,7,False
2012-04-25,3,11524,0,3,3,False
2012-04-25,4,11525,0,6,6,False
2012-04-25,5,11526,0,24,24,False
2012-04-25,6,11527,3,103,106,False
2012-04-25,7,11528,13,376,389,False
2012-04-25,8,11529,20,634,654,False
2012-04-25,9,11530,33,288,321,False
2012-04-25,10,11531,44,138,182,False
2012-04-25,11,11532,42,177,219,False
2012-04-25,12,11533,49,220,269,False
2012-04-25,13,11534,35,193,228,False
2012-04-25,14,11535,47,176,223,False
2012-04-25,15,11536,47,182,229,False
2012-04-25,16,11537,49,327,376,False
2012-04-25,17,11538,68,664,732,False
2012-04-25,18,11539,60,649,709,False
2012-04-25,19,11540,42,501,543,False
2012-04-25,20,11541,22,358,380,False
2012-04-25,21,11542,27,212,239,False
2012-04-25,22,11543,22,170,192,False
2012-04-25,23,11544,10,94,104,False
2012-04-26,0,11545,1,42,43,False
2012-04-26,1,11546,1,22,23,False
2012-04-26,2,11547,3,10,13,False
2012-04-26,3,11548,1,5,6,False
2012-04-26,4,11549,1,2,3,False
2012-04-26,5,11550,0,17,17,False
2012-04-26,6,11551,5,122,127,False
2012-04-26,7,11552,3,222,225,False
2012-04-26,8,11553,4,358,362,False
2012-04-26,9,11554,12,189,201,False
2012-04-26,10,11555,14,125,139,False
2012-04-26,11,11556,16,135,151,False
2012-04-26,12,11557,24,180,204,False
2012-04-26,13,11558,19,178,197,False
2012-04-26,14,11559,37,132,169,False
2012-04-26,15,11560,39,165,204,False
2012-04-26,16,11561,37,281,318,False
2012-04-26,17,11562,49,565,614,False
2012-04-26,18,11563,75,589,664,False
2012-04-26,19,11564,57,407,464,False
2012-04-26,20,11565,23,314,337,False
2012-04-26,21,11566,28,222,250,False
2012-04-26,22,11567,20,163,183,False
2012-04-26,23,11568,6,106,112,False
2012-04-27,0,11569,12,61,73,False
2012-04-27,1,11570,3,32,35,False
2012-04-27,2,11571,4,18,22,False
2012-04-27,3,11572,1,2,3,False
2012-04-27,4,11573,0,6,6,False
2012-04-27,5,11574,0,19,19,False
2012-04-27,6,11575,5,115,120,False
2012-04-27,7,11576,10,305,315,False
2012-04-27,8,11577,17,575,592,False
2012-04-27,9,11578,42,292,334,False
2012-04-27,10,11579,64,172,236,False
2012-04-27,11,11580,47,186,233,False
2012-04-27,12,11581,63,244,307,False
2012-04-27,13,11582,94,212,306,False
2012-04-27,14,11583,94,206,300,False
2012-04-27,15,11584,101,223,324,False
2012-04-27,16,11585,105,335,440,False
2012-04-27,17,11586,89,613,702,False
2012-04-27,18,11587,94,560,654,False
2012-04-27,19,11588,62,379,441,False
2012-04-27,20,11589,49,240,289,False
2012-04-27,21,11590,23,185,208,False
2012-04-27,22,11591,24,134,158,False
2012-04-27,23,11592,11,105,116,False
2012-04-28,0,11593,4,99,103,False
2012-04-28,1,11594,7,60,67,False
2012-04-28,2,11595,8,49,57,False
2012-04-28,3,11596,3,23,26,False
2012-04-28,4,11597,0,2,2,False
2012-04-28,5,11598,2,3,5,False
2012-04-28,6,11599,10,18,28,False
2012-04-28,7,11600,10,45,55,False
2012-04-28,8,11601,24,134,158,False
2012-04-28,9,11602,45,169,214,False
2012-04-28,10,11603,60,231,291,False
2012-04-28,11,11604,96,262,358,False
2012-04-28,12,11605,105,276,381,False
2012-04-28,13,11606,120,269,389,False
2012-04-28,14,11607,147,293,440,False
2012-04-28,15,11608,148,260,408,False
2012-04-28,16,11609,132,244,376,False
2012-04-28,17,11610,98,224,322,False
2012-04-28,18,11611,17,73,90,False
2012-04-28,19,11612,29,110,139,False
2012-04-28,20,11613,21,81,102,False
2012-04-28,21,11614,12,72,84,False
2012-04-28,22,11615,17,66,83,False
2012-04-28,23,11616,5,37,42,False
2012-04-29,0,11617,0,36,36,False
2012-04-29,1,11618,5,37,42,False
2012-04-29,2,11619,4,36,40,False
2012-04-29,3,11620,2,14,16,False
2012-04-29,4,11621,0,4,4,False
2012-04-29,5,11622,0,6,6,False
2012-04-29,6,11623,1,6,7,False
2012-04-29,7,11624,7,20,27,False
2012-04-29,8,11625,26,81,107,False
2012-04-29,9,11626,52,133,185,False
2012-04-29,10,11627,127,253,380,False
2012-04-29,11,11628,128,283,411,False
2012-04-29,12,11629,223,361,584,False
2012-04-29,13,11630,226,369,595,False
2012-04-29,14,11631,281,372,653,False
2012-04-29,15,11632,279,324,603,False
2012-04-29,16,11633,240,347,587,False
2012-04-29,17,11634,188,334,522,False
2012-04-29,18,11635,164,323,487,False
2012-04-29,19,11636,128,247,375,False
2012-04-29,20,11637,45,198,243,False
2012-04-29,21,11638,65,139,204,False
2012-04-29,22,11639,23,85,108,False
2012-04-29,23,11640,15,67,82,False
2012-04-30,0,11641,12,36,48,False
2012-04-30,1,11642,9,15,24,False
2012-04-30,2,11643,3,5,8,False
2012-04-30,3,11644,0,4,4,False
2012-04-30,4,11645,0,2,2,False
2012-04-30,5,11646,1,19,20,False
2012-04-30,6,11647,2,121,123,False
2012-04-30,7,11648,6,343,349,False
2012-04-30,8,11649,17,579,596,False
2012-04-30,9,11650,29,239,268,False
2012-04-30,10,11651,41,116,157,False
2012-04-30,11,11652,52,111,163,False
2012-04-30,12,11653,45,180,225,False
2012-04-30,13,11654,48,199,247,False
2012-04-30,14,11655,56,162,218,False
2012-04-30,15,11656,55,176,231,False
2012-04-30,16,11657,44,303,347,False
2012-04-30,17,11658,66,617,683,False
2012-04-30,18,11659,53,611,664,False
2012-04-30,19,11660,51,420,471,False
2012-04-30,20,11661,28,281,309,False
2012-04-30,21,11662,26,195,221,False
2012-04-30,22,11663,11,123,134,False
2012-04-30,23,11664,10,50,60,False
2012-05-01,0,11665,7,28,35,False
2012-05-01,1,11666,0,21,21,False
2012-05-01,2,11667,1,7,8,False
2012-05-01,3,11668,1,2,3,False
2012-05-01,4,11669,1,7,8,False
2012-05-01,5,11670,0,17,17,False
2012-05-01,6,11671,2,24,26,False
2012-05-01,7,11672,8,161,169,False
2012-05-01,8,11673,19,538,557,False
2012-05-01,9,11674,18,331,349,False
2012-05-01,10,11675,30,144,174,False
2012-05-01,11,11676,50,179,229,False
2012-05-01,12,11677,41,228,269,False
2012-05-01,13,11678,41,208,249,False
2012-05-01,14,11679,37,167,204,False
2012-05-01,15,11680,48,186,234,False
2012-05-01,16,11681,41,313,354,False
2012-05-01,17,11682,65,616,681,False
2012-05-01,18,11683,81,662,743,False
2012-05-01,19,11684,58,429,487,False
2012-05-01,20,11685,36,299,335,False
2012-05-01,21,11686,31,251,282,False
2012-05-01,22,11687,21,190,211,False
2012-05-01,23,11688,16,79,95,False
2012-05-02,0,11689,4,43,47,False
2012-05-02,1,11690,8,7,15,False
2012-05-02,2,11691,7,9,16,False
2012-05-02,3,11692,0,6,6,False
2012-05-02,4,11693,2,2,4,False
2012-05-02,5,11694,2,31,33,False
2012-05-02,6,11695,3,117,120,False
2012-05-02,7,11696,14,344,358,False
2012-05-02,8,11697,26,640,666,False
2012-05-02,9,11698,26,289,315,False
2012-05-02,10,11699,28,147,175,False
2012-05-02,11,11700,39,145,184,False
2012-05-02,12,11701,35,210,245,False
2012-05-02,13,11702,49,179,228,False
2012-05-02,14,11703,51,189,240,False
2012-05-02,15,11704,52,204,256,False
2012-05-02,16,11705,54,313,367,False
2012-05-02,17,11706,70,659,729,False
2012-05-02,18,11707,43,770,813,False
2012-05-02,19,11708,43,461,504,False
2012-05-02,20,11709,42,296,338,False
2012-05-02,21,11710,21,218,239,False
2012-05-02,22,11711,27,146,173,False
2012-05-02,23,11712,21,77,98,False
2012-05-03,0,11713,15,75,90,False
2012-05-03,1,11714,9,15,24,False
2012-05-03,2,11715,4,13,17,False
2012-05-03,3,11716,2,4,6,False
2012-05-03,4,11717,0,2,2,False
2012-05-03,5,11718,1,20,21,False
2012-05-03,6,11719,8,128,136,False
2012-05-03,7,11720,8,376,384,False
2012-05-03,8,11721,19,608,627,False
2012-05-03,9,11722,25,279,304,False
2012-05-03,10,11723,36,132,168,False
2012-05-03,11,11724,34,167,201,False
2012-05-03,12,11725,64,237,301,False
2012-05-03,13,11726,48,217,265,False
2012-05-03,14,11727,33,171,204,False
2012-05-03,15,11728,63,220,283,False
2012-05-03,16,11729,45,325,370,False
2012-05-03,17,11730,87,617,704,False
2012-05-03,18,11731,64,642,706,False
2012-05-03,19,11732,55,467,522,False
2012-05-03,20,11733,52,368,420,False
2012-05-03,21,11734,42,257,299,False
2012-05-03,22,11735,29,217,246,False
2012-05-03,23,11736,21,100,121,False
2012-05-04,0,11737,19,70,89,False
2012-05-04,1,11738,15,33,48,False
2012-05-04,2,11739,0,11,11,False
2012-05-04,3,11740,0,14,14,False
2012-05-04,4,11741,0,4,4,False
2012-05-04,5,11742,0,24,24,False
2012-05-04,6,11743,8,127,135,False
2012-05-04,7,11744,9,347,356,False
2012-05-04,8,11745,34,584,618,False
2012-05-04,9,11746,32,262,294,False
2012-05-04,10,11747,45,154,199,False
2012-05-04,11,11748,77,181,258,False
2012-05-04,12,11749,46,125,171,False
2012-05-04,13,11750,71,207,278,False
2012-05-04,14,11751,83,159,242,False
2012-05-04,15,11752,103,240,343,False
2012-05-04,16,11753,82,358,440,False
2012-05-04,17,11754,96,547,643,False
2012-05-04,18,11755,77,564,641,False
2012-05-04,19,11756,64,388,452,False
2012-05-04,20,11757,58,255,313,False
2012-05-04,21,11758,49,186,235,False
2012-05-04,22,11759,50,182,232,False
2012-05-04,23,11760,51,205,256,False
2012-05-05,0,11761,42,111,153,False
2012-05-05,1,11762,28,79,107,False
2012-05-05,2,11763,24,51,75,False
2012-05-05,3,11764,11,21,32,False
2012-05-05,4,11765,0,9,9,False
2012-05-05,5,11766,8,14,22,False
2012-05-05,6,11767,9,33,42,False
2012-05-05,7,11768,8,79,87,False
2012-05-05,8,11769,42,155,197,False
2012-05-05,9,11770,61,223,284,False
2012-05-05,10,11771,148,284,432,False
2012-05-05,11,11772,221,354,575,False
2012-05-05,12,11773,220,330,550,False
2012-05-05,13,11774,217,307,524,False
2012-05-05,14,11775,187,241,428,False
2012-05-05,15,11776,241,300,541,False
2012-05-05,16,11777,230,310,540,False
2012-05-05,17,11778,204,298,502,False
2012-05-05,18,11779,156,278,434,False
2012-05-05,19,11780,151,254,405,False
2012-05-05,20,11781,100,209,309,False
2012-05-05,21,11782,86,183,269,False
2012-05-05,22,11783,67,150,217,False
2012-05-05,23,11784,35,114,149,False
2012-05-06,0,11785,23,111,134,False
2012-05-06,1,11786,37,84,121,False
2012-05-06,2,11787,29,64,93,False
2012-05-06,3,11788,9,19,28,False
2012-05-06,4,11789,9,7,16,False
2012-05-06,5,11790,1,10,11,False
2012-05-06,6,11791,3,14,17,False
2012-05-06,7,11792,5,31,36,False
2012-05-06,8,11793,23,91,114,False
2012-05-06,9,11794,63,128,191,False
2012-05-06,10,11795,112,221,333,False
2012-05-06,11,11796,144,270,414,False
2012-05-06,12,11797,207,351,558,False
2012-05-06,13,11798,197,368,565,False
2012-05-06,14,11799,226,292,518,False
2012-05-06,15,11800,229,342,571,False
2012-05-06,16,11801,181,363,544,False
2012-05-06,17,11802,195,316,511,False
2012-05-06,18,11803,131,332,463,False
2012-05-06,19,11804,117,266,383,False
2012-05-06,20,11805,73,203,276,False
2012-05-06,21,11806,55,148,203,False
2012-05-06,22,11807,44,113,157,False
2012-05-06,23,11808,22,80,102,False
2012-05-07,0,11809,13,21,34,False
2012-05-07,1,11810,1,8,9,False
2012-05-07,2,11811,1,5,6,False
2012-05-07,3,11812,2,3,5,False
2012-05-07,4,11813,0,2,2,False
2012-05-07,5,11814,2,21,23,False
2012-05-07,6,11815,8,134,142,False
2012-05-07,7,11816,18,367,385,False
2012-05-07,8,11817,31,608,639,False
2012-05-07,9,11818,61,289,350,False
2012-05-07,10,11819,62,128,190,False
2012-05-07,11,11820,64,149,213,False
2012-05-07,12,11821,74,189,263,False
2012-05-07,13,11822,75,197,272,False
2012-05-07,14,11823,59,180,239,False
2012-05-07,15,11824,76,186,262,False
2012-05-07,16,11825,68,320,388,False
2012-05-07,17,11826,102,667,769,False
2012-05-07,18,11827,78,602,680,False
2012-05-07,19,11828,83,463,546,False
2012-05-07,20,11829,46,277,323,False
2012-05-07,21,11830,37,210,247,False
2012-05-07,22,11831,26,147,173,False
2012-05-07,23,11832,21,92,113,False
2012-05-08,0,11833,10,28,38,False
2012-05-08,1,11834,6,3,9,False
2012-05-08,2,11835,9,7,16,False
2012-05-08,3,11836,2,4,6,False
2012-05-08,4,11837,0,5,5,False
2012-05-08,5,11838,0,20,20,False
2012-05-08,6,11839,7,158,165,False
2012-05-08,7,11840,21,442,463,False
2012-05-08,8,11841,36,605,641,False
2012-05-08,9,11842,37,258,295,False
2012-05-08,10,11843,46,111,157,False
2012-05-08,11,11844,60,157,217,False
2012-05-08,12,11845,60,203,263,False
2012-05-08,13,11846,53,166,219,False
2012-05-08,14,11847,8,63,71,False
2012-05-08,15,11848,40,94,134,False
2012-05-08,16,11849,54,335,389,False
2012-05-08,17,11850,77,640,717,False
2012-05-08,18,11851,69,641,710,False
2012-05-08,19,11852,59,399,458,False
2012-05-08,20,11853,40,262,302,False
2012-05-08,21,11854,21,202,223,False
2012-05-08,22,11855,13,134,147,False
2012-05-08,23,11856,10,53,63,False
2012-05-09,0,11857,8,27,35,False
2012-05-09,1,11858,3,11,14,False
2012-05-09,2,11859,0,1,1,False
2012-05-09,3,11860,0,2,2,False
2012-05-09,4,11861,0,5,5,False
2012-05-09,5,11862,1,27,28,False
2012-05-09,6,11863,5,121,126,False
2012-05-09,7,11864,17,401,418,False
2012-05-09,8,11865,28,594,622,False
2012-05-09,9,11866,40,285,325,False
2012-05-09,10,11867,40,113,153,False
2012-05-09,11,11868,45,156,201,False
2012-05-09,12,11869,58,222,280,False
2012-05-09,13,11870,50,216,266,False
2012-05-09,14,11871,68,175,243,False
2012-05-09,15,11872,68,191,259,False
2012-05-09,16,11873,68,289,357,False
2012-05-09,17,11874,76,629,705,False
2012-05-09,18,11875,23,349,372,False
2012-05-09,19,11876,2,96,98,False
2012-05-09,20,11877,3,48,51,False
2012-05-09,21,11878,4,30,34,False
2012-05-09,22,11879,5,62,67,False
2012-05-09,23,11880,8,47,55,False
2012-05-10,0,11881,2,31,33,False
2012-05-10,1,11882,2,9,11,False
2012-05-10,2,11883,0,3,3,False
2012-05-10,3,11884,0,3,3,False
2012-05-10,4,11885,0,2,2,False
2012-05-10,5,11886,1,23,24,False
2012-05-10,6,11887,9,130,139,False
2012-05-10,7,11888,8,393,401,False
2012-05-10,8,11889,27,603,630,False
2012-05-10,9,11890,62,299,361,False
2012-05-10,10,11891,42,112,154,False
2012-05-10,11,11892,77,179,256,False
2012-05-10,12,11893,65,207,272,False
2012-05-10,13,11894,90,228,318,False
2012-05-10,14,11895,61,186,247,False
2012-05-10,15,11896,79,192,271,False
2012-05-10,16,11897,87,334,421,False
2012-05-10,17,11898,84,648,732,False
2012-05-10,18,11899,109,661,770,False
2012-05-10,19,11900,84,469,553,False
2012-05-10,20,11901,59,315,374,False
2012-05-10,21,11902,19,211,230,False
2012-05-10,22,11903,36,196,232,False
2012-05-10,23,11904,23,112,135,False
2012-05-11,0,11905,17,47,64,False
2012-05-11,1,11906,14,32,46,False
2012-05-11,2,11907,15,16,31,False
2012-05-11,3,11908,5,8,13,False
2012-05-11,4,11909,3,6,9,False
2012-05-11,5,11910,3,23,26,False
2012-05-11,6,11911,7,128,135,False
2012-05-11,7,11912,6,345,351,False
2012-05-11,8,11913,41,579,620,False
2012-05-11,9,11914,34,288,322,False
2012-05-11,10,11915,69,141,210,False
2012-05-11,11,11916,88,203,291,False
2012-05-11,12,11917,89,259,348,False
2012-05-11,13,11918,100,263,363,False
2012-05-11,14,11919,116,218,334,False
2012-05-11,15,11920,140,299,439,False
2012-05-11,16,11921,128,397,525,False
2012-05-11,17,11922,102,677,779,False
2012-05-11,18,11923,78,518,596,False
2012-05-11,19,11924,73,430,503,False
2012-05-11,20,11925,64,277,341,False
2012-05-11,21,11926,45,225,270,False
2012-05-11,22,11927,44,190,234,False
2012-05-11,23,11928,38,142,180,False
2012-05-12,0,11929,25,111,136,False
2012-05-12,1,11930,14,79,93,False
2012-05-12,2,11931,10,46,56,False
2012-05-12,3,11932,14,20,34,False
2012-05-12,4,11933,3,6,9,False
2012-05-12,5,11934,5,8,13,False
2012-05-12,6,11935,10,23,33,False
2012-05-12,7,11936,10,57,67,False
2012-05-12,8,11937,22,156,178,False
2012-05-12,9,11938,87,248,335,False
2012-05-12,10,11939,132,279,411,False
2012-05-12,11,11940,157,365,522,False
2012-05-12,12,11941,206,353,559,False
2012-05-12,13,11942,293,366,659,False
2012-05-12,14,11943,257,358,615,False
2012-05-12,15,11944,269,321,590,False
2012-05-12,16,11945,254,337,591,False
2012-05-12,17,11946,233,343,576,False
2012-05-12,18,11947,164,382,546,False
2012-05-12,19,11948,166,273,439,False
2012-05-12,20,11949,113,174,287,False
2012-05-12,21,11950,74,156,230,False
2012-05-12,22,11951,62,212,274,False
2012-05-12,23,11952,42,134,176,False
2012-05-13,0,11953,19,79,98,False
2012-05-13,1,11954,22,72,94,False
2012-05-13,2,11955,22,60,82,False
2012-05-13,3,11956,2,26,28,False
2012-05-13,4,11957,2,7,9,False
2012-05-13,5,11958,4,8,12,False
2012-05-13,6,11959,6,15,21,False
2012-05-13,7,11960,18,42,60,False
2012-05-13,8,11961,32,124,156,False
2012-05-13,9,11962,79,143,222,False
2012-05-13,10,11963,128,222,350,False
2012-05-13,11,11964,150,278,428,False
2012-05-13,12,11965,189,342,531,False
2012-05-13,13,11966,255,347,602,False
2012-05-13,14,11967,228,324,552,False
2012-05-13,15,11968,190,309,499,False
2012-05-13,16,11969,225,339,564,False
2012-05-13,17,11970,191,287,478,False
2012-05-13,18,11971,129,260,389,False
2012-05-13,19,11972,107,232,339,False
2012-05-13,20,11973,67,163,230,False
2012-05-13,21,11974,48,121,169,False
2012-05-13,22,11975,42,89,131,False
2012-05-13,23,11976,17,57,74,False
2012-05-14,0,11977,21,14,35,False
2012-05-14,1,11978,5,6,11,False
2012-05-14,2,11979,1,1,2,False
2012-05-14,3,11980,0,2,2,False
2012-05-14,4,11981,3,3,6,False
2012-05-14,5,11982,1,25,26,False
2012-05-14,6,11983,3,62,65,False
2012-05-14,7,11984,3,72,75,False
2012-05-14,8,11985,1,155,156,False
2012-05-14,9,11986,5,105,110,False
2012-05-14,10,11987,6,53,59,False
2012-05-14,11,11988,12,67,79,False
2012-05-14,12,11989,53,132,185,False
2012-05-14,13,11990,33,143,176,False
2012-05-14,14,11991,43,128,171,False
2012-05-14,15,11992,40,156,196,False
2012-05-14,16,11993,20,91,111,False
2012-05-14,17,11994,25,204,229,False
2012-05-14,18,11995,17,283,300,False
2012-05-14,19,11996,10,294,304,False
2012-05-14,20,11997,11,178,189,False
2012-05-14,21,11998,7,145,152,False
2012-05-14,22,11999,11,118,129,False
2012-05-14,23,12000,11,64,75,False
2012-05-15,0,12001,7,25,32,False
2012-05-15,1,12002,5,14,19,False
2012-05-15,2,12003,1,3,4,False
2012-05-15,3,12004,1,5,6,False
2012-05-15,4,12005,1,4,5,False
2012-05-15,5,12006,0,8,8,False
2012-05-15,6,12007,2,22,24,False
2012-05-15,7,12008,1,91,92,False
2012-05-15,8,12009,8,401,409,False
2012-05-15,9,12010,28,327,355,False
2012-05-15,10,12011,27,144,171,False
2012-05-15,11,12012,38,186,224,False
2012-05-15,12,12013,44,220,264,False
2012-05-15,13,12014,35,204,239,False
2012-05-15,14,12015,39,145,184,False
2012-05-15,15,12016,51,205,256,False
2012-05-15,16,12017,74,300,374,False
2012-05-15,17,12018,75,603,678,False
2012-05-15,18,12019,68,665,733,False
2012-05-15,19,12020,57,455,512,False
2012-05-15,20,12021,30,233,263,False
2012-05-15,21,12022,11,98,109,False
2012-05-15,22,12023,9,74,83,False
2012-05-15,23,12024,13,58,71,False
2012-05-16,0,12025,12,27,39,False
2012-05-16,1,12026,7,14,21,False
2012-05-16,2,12027,5,14,19,False
2012-05-16,3,12028,1,5,6,False
2012-05-16,4,12029,1,3,4,False
2012-05-16,5,12030,4,34,38,False
2012-05-16,6,12031,8,150,158,False
2012-05-16,7,12032,14,426,440,False
2012-05-16,8,12033,33,617,650,False
2012-05-16,9,12034,33,314,347,False
2012-05-16,10,12035,43,149,192,False
2012-05-16,11,12036,55,212,267,False
2012-05-16,12,12037,59,271,330,False
2012-05-16,13,12038,77,273,350,False
2012-05-16,14,12039,42,221,263,False
2012-05-16,15,12040,52,222,274,False
2012-05-16,16,12041,70,376,446,False
2012-05-16,17,12042,104,769,873,False
2012-05-16,18,12043,97,749,846,False
2012-05-16,19,12044,91,499,590,False
2012-05-16,20,12045,61,398,459,False
2012-05-16,21,12046,63,330,393,False
2012-05-16,22,12047,33,253,286,False
2012-05-16,23,12048,26,107,133,False
2012-05-17,0,12049,30,49,79,False
2012-05-17,1,12050,12,16,28,False
2012-05-17,2,12051,8,8,16,False
2012-05-17,3,12052,0,3,3,False
2012-05-17,4,12053,3,13,16,False
2012-05-17,5,12054,1,34,35,False
2012-05-17,6,12055,10,149,159,False
2012-05-17,7,12056,25,449,474,False
2012-05-17,8,12057,29,605,634,False
2012-05-17,9,12058,57,289,346,False
2012-05-17,10,12059,43,162,205,False
2012-05-17,11,12060,77,202,279,False
2012-05-17,12,12061,72,276,348,False
2012-05-17,13,12062,86,241,327,False
2012-05-17,14,12063,68,202,270,False
2012-05-17,15,12064,83,233,316,False
2012-05-17,16,12065,86,344,430,False
2012-05-17,17,12066,133,719,852,False
2012-05-17,18,12067,134,734,868,False
2012-05-17,19,12068,86,451,537,False
2012-05-17,20,12069,83,363,446,False
2012-05-17,21,12070,45,254,299,False
2012-05-17,22,12071,42,209,251,False
2012-05-17,23,12072,29,137,166,False
2012-05-18,0,12073,13,57,70,False
2012-05-18,1,12074,16,33,49,False
2012-05-18,2,12075,12,9,21,False
2012-05-18,3,12076,6,8,14,False
2012-05-18,4,12077,0,11,11,False
2012-05-18,5,12078,1,33,34,False
2012-05-18,6,12079,14,168,182,False
2012-05-18,7,12080,40,475,515,False
2012-05-18,8,12081,49,696,745,False
2012-05-18,9,12082,57,304,361,False
2012-05-18,10,12083,74,181,255,False
2012-05-18,11,12084,109,225,334,False
2012-05-18,12,12085,108,252,360,False
2012-05-18,13,12086,98,297,395,False
2012-05-18,14,12087,108,242,350,False
2012-05-18,15,12088,131,260,391,False
2012-05-18,16,12089,151,417,568,False
2012-05-18,17,12090,124,688,812,False
2012-05-18,18,12091,99,570,669,False
2012-05-18,19,12092,91,392,483,False
2012-05-18,20,12093,73,264,337,False
2012-05-18,21,12094,49,209,258,False
2012-05-18,22,12095,57,194,251,False
2012-05-18,23,12096,41,133,174,False
2012-05-19,0,12097,30,118,148,False
2012-05-19,1,12098,20,84,104,False
2012-05-19,2,12099,13,56,69,False
2012-05-19,3,12100,10,23,33,False
2012-05-19,4,12101,6,8,14,False
2012-05-19,5,12102,1,11,12,False
2012-05-19,6,12103,12,38,50,False
2012-05-19,7,12104,28,67,95,False
2012-05-19,8,12105,33,162,195,False
2012-05-19,9,12106,79,213,292,False
2012-05-19,10,12107,177,275,452,False
2012-05-19,11,12108,235,351,586,False
2012-05-19,12,12109,276,366,642,False
2012-05-19,13,12110,332,372,704,False
2012-05-19,14,12111,361,369,730,False
2012-05-19,15,12112,356,316,672,False
2012-05-19,16,12113,331,311,642,False
2012-05-19,17,12114,279,347,626,False
2012-05-19,18,12115,254,391,645,False
2012-05-19,19,12116,203,229,432,False
2012-05-19,20,12117,118,197,315,False
2012-05-19,21,12118,81,178,259,False
2012-05-19,22,12119,104,234,338,False
2012-05-19,23,12120,71,168,239,False
2012-05-20,0,12121,42,128,170,False
2012-05-20,1,12122,28,102,130,False
2012-05-20,2,12123,36,62,98,False
2012-05-20,3,12124,26,40,66,False
2012-05-20,4,12125,2,14,16,False
2012-05-20,5,12126,1,7,8,False
2012-05-20,6,12127,4,21,25,False
2012-05-20,7,12128,35,55,90,False
2012-05-20,8,12129,51,120,171,False
2012-05-20,9,12130,129,184,313,False
2012-05-20,10,12131,174,258,432,False
2012-05-20,11,12132,258,323,581,False
2012-05-20,12,12133,247,390,637,False
2012-05-20,13,12134,244,363,607,False
2012-05-20,14,12135,236,307,543,False
2012-05-20,15,12136,246,256,502,False
2012-05-20,16,12137,238,339,577,False
2012-05-20,17,12138,209,340,549,False
2012-05-20,18,12139,146,328,474,False
2012-05-20,19,12140,142,260,402,False
2012-05-20,20,12141,83,191,274,False
2012-05-20,21,12142,51,182,233,False
2012-05-20,22,12143,44,101,145,False
2012-05-20,23,12144,32,54,86,False
2012-05-21,0,12145,12,28,40,False
2012-05-21,1,12146,4,11,15,False
2012-05-21,2,12147,2,9,11,False
2012-05-21,3,12148,0,2,2,False
2012-05-21,4,12149,2,5,7,False
2012-05-21,5,12150,1,14,15,False
2012-05-21,6,12151,3,76,79,False
2012-05-21,7,12152,7,146,153,False
2012-05-21,8,12153,12,258,270,False
2012-05-21,9,12154,14,172,186,False
2012-05-21,10,12155,28,71,99,False
2012-05-21,11,12156,24,82,106,False
2012-05-21,12,12157,46,124,170,False
2012-05-21,13,12158,49,135,184,False
2012-05-21,14,12159,45,135,180,False
2012-05-21,15,12160,67,158,225,False
2012-05-21,16,12161,46,269,315,False
2012-05-21,17,12162,40,468,508,False
2012-05-21,18,12163,52,478,530,False
2012-05-21,19,12164,57,391,448,False
2012-05-21,20,12165,44,292,336,False
2012-05-21,21,12166,31,210,241,False
2012-05-21,22,12167,26,116,142,False
2012-05-21,23,12168,18,79,97,False
2012-05-22,0,12169,10,26,36,False
2012-05-22,1,12170,11,16,27,False
2012-05-22,2,12171,1,10,11,False
2012-05-22,3,12172,0,5,5,False
2012-05-22,4,12173,0,7,7,False
2012-05-22,5,12174,0,17,17,False
2012-05-22,6,12175,8,129,137,False
2012-05-22,7,12176,9,315,324,False
2012-05-22,8,12177,20,570,590,False
2012-05-22,9,12178,46,287,333,False
2012-05-22,10,12179,52,148,200,False
2012-05-22,11,12180,39,150,189,False
2012-05-22,12,12181,76,178,254,False
2012-05-22,13,12182,48,195,243,False
2012-05-22,14,12183,73,149,222,False
2012-05-22,15,12184,54,191,245,False
2012-05-22,16,12185,70,316,386,False
2012-05-22,17,12186,69,716,785,False
2012-05-22,18,12187,76,709,785,False
2012-05-22,19,12188,44,320,364,False
2012-05-22,20,12189,54,319,373,False
2012-05-22,21,12190,28,233,261,False
2012-05-22,22,12191,17,157,174,False
2012-05-22,23,12192,14,91,105,False
2012-05-23,0,12193,19,28,47,False
2012-05-23,1,12194,23,9,32,False
2012-05-23,2,12195,2,10,12,False
2012-05-23,3,12196,0,5,5,False
2012-05-23,4,12197,0,3,3,False
2012-05-23,5,12198,6,29,35,False
2012-05-23,6,12199,6,154,160,False
2012-05-23,7,12200,16,452,468,False
2012-05-23,8,12201,38,681,719,False
2012-05-23,9,12202,39,258,297,False
2012-05-23,10,12203,52,139,191,False
2012-05-23,11,12204,46,151,197,False
2012-05-23,12,12205,42,206,248,False
2012-05-23,13,12206,69,201,270,False
2012-05-23,14,12207,67,181,248,False
2012-05-23,15,12208,65,192,257,False
2012-05-23,16,12209,62,216,278,False
2012-05-23,17,12210,45,240,285,False
2012-05-23,18,12211,31,296,327,False
2012-05-23,19,12212,40,336,376,False
2012-05-23,20,12213,28,267,295,False
2012-05-23,21,12214,24,221,245,False
2012-05-23,22,12215,23,136,159,False
2012-05-23,23,12216,23,83,106,False
2012-05-24,0,12217,7,49,56,False
2012-05-24,1,12218,9,21,30,False
2012-05-24,2,12219,1,15,16,False
2012-05-24,3,12220,1,3,4,False
2012-05-24,4,12221,0,5,5,False
2012-05-24,5,12222,1,29,30,False
2012-05-24,6,12223,10,146,156,False
2012-05-24,7,12224,22,393,415,False
2012-05-24,8,12225,33,659,692,False
2012-05-24,9,12226,34,267,301,False
2012-05-24,10,12227,47,138,185,False
2012-05-24,11,12228,61,160,221,False
2012-05-24,12,12229,76,213,289,False
2012-05-24,13,12230,69,233,302,False
2012-05-24,14,12231,72,180,252,False
2012-05-24,15,12232,69,222,291,False
2012-05-24,16,12233,61,329,390,False
2012-05-24,17,12234,120,678,798,False
2012-05-24,18,12235,118,634,752,False
2012-05-24,19,12236,76,416,492,False
2012-05-24,20,12237,55,343,398,False
2012-05-24,21,12238,48,237,285,False
2012-05-24,22,12239,33,210,243,False
2012-05-24,23,12240,36,131,167,False
2012-05-25,0,12241,10,63,73,False
2012-05-25,1,12242,8,34,42,False
2012-05-25,2,12243,7,16,23,False
2012-05-25,3,12244,8,6,14,False
2012-05-25,4,12245,3,6,9,False
2012-05-25,5,12246,2,28,30,False
2012-05-25,6,12247,5,108,113,False
2012-05-25,7,12248,7,352,359,False
2012-05-25,8,12249,32,551,583,False
2012-05-25,9,12250,52,288,340,False
2012-05-25,10,12251,69,163,232,False
2012-05-25,11,12252,90,193,283,False
2012-05-25,12,12253,84,237,321,False
2012-05-25,13,12254,86,247,333,False
2012-05-25,14,12255,104,263,367,False
2012-05-25,15,12256,106,360,466,False
2012-05-25,16,12257,137,447,584,False
2012-05-25,17,12258,124,529,653,False
2012-05-25,18,12259,131,391,522,False
2012-05-25,19,12260,111,293,404,False
2012-05-25,20,12261,80,270,350,False
2012-05-25,21,12262,62,193,255,False
2012-05-25,22,12263,65,147,212,False
2012-05-25,23,12264,34,132,166,False
2012-05-26,0,12265,18,98,116,False
2012-05-26,1,12266,18,64,82,False
2012-05-26,2,12267,9,55,64,False
2012-05-26,3,12268,9,22,31,False
2012-05-26,4,12269,0,2,2,False
2012-05-26,5,12270,0,10,10,False
2012-05-26,6,12271,6,25,31,False
2012-05-26,7,12272,10,44,54,False
2012-05-26,8,12273,38,103,141,False
2012-05-26,9,12274,97,192,289,False
2012-05-26,10,12275,181,256,437,False
2012-05-26,11,12276,208,312,520,False
2012-05-26,12,12277,236,293,529,False
2012-05-26,13,12278,265,274,539,False
2012-05-26,14,12279,307,257,564,False
2012-05-26,15,12280,274,239,513,False
2012-05-26,16,12281,261,243,504,False
2012-05-26,17,12282,235,227,462,False
2012-05-26,18,12283,199,216,415,False
2012-05-26,19,12284,159,214,373,False
2012-05-26,20,12285,103,152,255,False
2012-05-26,21,12286,100,151,251,False
2012-05-26,22,12287,86,118,204,False
2012-05-26,23,12288,36,114,150,False
2012-05-27,0,12289,48,89,137,False
2012-05-27,1,12290,17,61,78,False
2012-05-27,2,12291,16,45,61,False
2012-05-27,3,12292,11,25,36,False
2012-05-27,4,12293,4,7,11,False
2012-05-27,5,12294,2,5,7,False
2012-05-27,6,12295,8,14,22,False
2012-05-27,7,12296,22,30,52,False
2012-05-27,8,12297,69,82,151,False
2012-05-27,9,12298,130,140,270,False
2012-05-27,10,12299,209,215,424,False
2012-05-27,11,12300,268,251,519,False
2012-05-27,12,12301,301,269,570,False
2012-05-27,13,12302,270,228,498,False
2012-05-27,14,12303,317,230,547,False
2012-05-27,15,12304,290,245,535,False
2012-05-27,16,12305,258,243,501,False
2012-05-27,17,12306,275,247,522,False
2012-05-27,18,12307,266,252,518,False
2012-05-27,19,12308,230,212,442,False
2012-05-27,20,12309,168,224,392,False
2012-05-27,21,12310,64,79,143,False
2012-05-27,22,12311,9,50,59,False
2012-05-27,23,12312,31,65,96,False
2012-05-28,0,12313,21,44,65,False
2012-05-28,1,12314,14,45,59,False
2012-05-28,2,12315,20,28,48,False
2012-05-28,3,12316,6,12,18,False
2012-05-28,4,12317,2,4,6,False
2012-05-28,5,12318,4,5,9,False
2012-05-28,6,12319,6,14,20,False
2012-05-28,7,12320,24,43,67,False
2012-05-28,8,12321,62,93,155,False
2012-05-28,9,12322,121,142,263,False
2012-05-28,10,12323,189,175,364,False
2012-05-28,11,12324,254,222,476,False
2012-05-28,12,12325,233,292,525,False
2012-05-28,13,12326,272,284,556,False
2012-05-28,14,12327,238,227,465,False
2012-05-28,15,12328,181,279,460,False
2012-05-28,16,12329,223,278,501,False
2012-05-28,17,12330,158,247,405,False
2012-05-28,18,12331,132,251,383,False
2012-05-28,19,12332,148,247,395,False
2012-05-28,20,12333,114,203,317,False
2012-05-28,21,12334,66,181,247,False
2012-05-28,22,12335,47,110,157,False
2012-05-28,23,12336,22,60,82,False
2012-05-29,0,12337,12,33,45,False
2012-05-29,1,12338,1,13,14,False
2012-05-29,2,12339,0,8,8,False
2012-05-29,3,12340,1,2,3,False
2012-05-29,4,12341,0,5,5,False
2012-05-29,5,12342,1,32,33,False
2012-05-29,6,12343,9,145,154,False
2012-05-29,7,12344,19,431,450,False
2012-05-29,8,12345,46,588,634,False
2012-05-29,9,12346,26,231,257,False
2012-05-29,10,12347,67,116,183,False
2012-05-29,11,12348,50,147,197,False
2012-05-29,12,12349,56,181,237,False
2012-05-29,13,12350,63,176,239,False
2012-05-29,14,12351,80,158,238,False
2012-05-29,15,12352,71,185,256,False
2012-05-29,16,12353,73,320,393,False
2012-05-29,17,12354,107,674,781,False
2012-05-29,18,12355,78,632,710,False
2012-05-29,19,12356,69,457,526,False
2012-05-29,20,12357,36,168,204,False
2012-05-29,21,12358,3,68,71,False
2012-05-29,22,12359,2,53,55,False
2012-05-29,23,12360,10,40,50,False
2012-05-30,0,12361,4,32,36,False
2012-05-30,1,12362,0,4,4,False
2012-05-30,2,12363,1,4,5,False
2012-05-30,3,12364,0,5,5,False
2012-05-30,4,12365,0,6,6,False
2012-05-30,5,12366,1,40,41,False
2012-05-30,6,12367,5,139,144,False
2012-05-30,7,12368,14,469,483,False
2012-05-30,8,12369,29,642,671,False
2012-05-30,9,12370,23,282,305,False
2012-05-30,10,12371,39,138,177,False
2012-05-30,11,12372,53,155,208,False
2012-05-30,12,12373,33,220,253,False
2012-05-30,13,12374,53,236,289,False
2012-05-30,14,12375,44,208,252,False
2012-05-30,15,12376,54,221,275,False
2012-05-30,16,12377,46,352,398,False
2012-05-30,17,12378,83,756,839,False
2012-05-30,18,12379,50,746,796,False
2012-05-30,19,12380,50,506,556,False
2012-05-30,20,12381,57,374,431,False
2012-05-30,21,12382,41,263,304,False
2012-05-30,22,12383,26,191,217,False
2012-05-30,23,12384,39,121,160,False
2012-05-31,0,12385,13,48,61,False
2012-05-31,1,12386,4,22,26,False
2012-05-31,2,12387,6,8,14,False
2012-05-31,3,12388,0,8,8,False
2012-05-31,4,12389,0,8,8,False
2012-05-31,5,12390,1,32,33,False
2012-05-31,6,12391,7,171,178,False
2012-05-31,7,12392,18,489,507,False
2012-05-31,8,12393,18,675,693,False
2012-05-31,9,12394,47,264,311,False
2012-05-31,10,12395,65,155,220,False
2012-05-31,11,12396,65,153,218,False
2012-05-31,12,12397,62,230,292,False
2012-05-31,13,12398,77,216,293,False
2012-05-31,14,12399,61,193,254,False
2012-05-31,15,12400,81,209,290,False
2012-05-31,16,12401,103,384,487,False
2012-05-31,17,12402,85,742,827,False
2012-05-31,18,12403,85,700,785,False
2012-05-31,19,12404,104,487,591,False
2012-05-31,20,12405,88,391,479,False
2012-05-31,21,12406,41,318,359,False
2012-05-31,22,12407,43,221,264,False
2012-05-31,23,12408,26,114,140,False
2012-06-01,0,12409,10,76,86,False
2012-06-01,1,12410,0,34,34,False
2012-06-01,2,12411,3,13,16,False
2012-06-01,3,12412,0,4,4,False
2012-06-01,4,12413,1,5,6,False
2012-06-01,5,12414,4,41,45,False
2012-06-01,6,12415,5,136,141,False
2012-06-01,7,12416,33,369,402,False
2012-06-01,8,12417,19,675,694,False
2012-06-01,9,12418,24,274,298,False
2012-06-01,10,12419,49,155,204,False
2012-06-01,11,12420,42,193,235,False
2012-06-01,12,12421,72,238,310,False
2012-06-01,13,12422,76,240,316,False
2012-06-01,14,12423,55,199,254,False
2012-06-01,15,12424,45,213,258,False
2012-06-01,16,12425,36,186,222,False
2012-06-01,17,12426,25,202,227,False
2012-06-01,18,12427,10,100,110,False
2012-06-01,19,12428,4,41,45,False
2012-06-01,20,12429,1,38,39,False
2012-06-01,21,12430,12,73,85,False
2012-06-01,22,12431,1,22,23,False
2012-06-01,23,12432,6,67,73,False
2012-06-02,0,12433,5,81,86,False
2012-06-02,1,12434,15,61,76,False
2012-06-02,2,12435,3,38,41,False
2012-06-02,3,12436,8,18,26,False
2012-06-02,4,12437,2,11,13,False
2012-06-02,5,12438,1,11,12,False
2012-06-02,6,12439,5,31,36,False
2012-06-02,7,12440,9,77,86,False
2012-06-02,8,12441,30,180,210,False
2012-06-02,9,12442,89,243,332,False
2012-06-02,10,12443,145,348,493,False
2012-06-02,11,12444,179,357,536,False
2012-06-02,12,12445,250,418,668,False
2012-06-02,13,12446,279,400,679,False
2012-06-02,14,12447,259,388,647,False
2012-06-02,15,12448,297,405,702,False
2012-06-02,16,12449,275,369,644,False
2012-06-02,17,12450,248,338,586,False
2012-06-02,18,12451,171,341,512,False
2012-06-02,19,12452,185,369,554,False
2012-06-02,20,12453,139,260,399,False
2012-06-02,21,12454,96,220,316,False
2012-06-02,22,12455,52,176,228,False
2012-06-02,23,12456,53,185,238,False
2012-06-03,0,12457,27,142,169,False
2012-06-03,1,12458,21,100,121,False
2012-06-03,2,12459,22,67,89,False
2012-06-03,3,12460,16,34,50,False
2012-06-03,4,12461,1,12,13,False
2012-06-03,5,12462,1,11,12,False
2012-06-03,6,12463,6,16,22,False
2012-06-03,7,12464,6,29,35,False
2012-06-03,8,12465,30,110,140,False
2012-06-03,9,12466,70,230,300,False
2012-06-03,10,12467,127,277,404,False
2012-06-03,11,12468,199,312,511,False
2012-06-03,12,12469,276,408,684,False
2012-06-03,13,12470,265,421,686,False
2012-06-03,14,12471,267,411,678,False
2012-06-03,15,12472,236,408,644,False
2012-06-03,16,12473,226,436,662,False
2012-06-03,17,12474,192,386,578,False
2012-06-03,18,12475,153,343,496,False
2012-06-03,19,12476,116,337,453,False
2012-06-03,20,12477,84,230,314,False
2012-06-03,21,12478,66,180,246,False
2012-06-03,22,12479,61,165,226,False
2012-06-03,23,12480,26,82,108,False
2012-06-04,0,12481,11,38,49,False
2012-06-04,1,12482,4,10,14,False
2012-06-04,2,12483,1,10,11,False
2012-06-04,3,12484,0,5,5,False
2012-06-04,4,12485,2,6,8,False
2012-06-04,5,12486,2,33,35,False
2012-06-04,6,12487,4,135,139,False
2012-06-04,7,12488,13,504,517,False
2012-06-04,8,12489,22,643,665,False
2012-06-04,9,12490,38,244,282,False
2012-06-04,10,12491,67,120,187,False
2012-06-04,11,12492,71,168,239,False
2012-06-04,12,12493,62,220,282,False
2012-06-04,13,12494,85,189,274,False
2012-06-04,14,12495,84,186,270,False
2012-06-04,15,12496,77,215,292,False
2012-06-04,16,12497,73,375,448,False
2012-06-04,17,12498,101,733,834,False
2012-06-04,18,12499,103,719,822,False
2012-06-04,19,12500,91,554,645,False
2012-06-04,20,12501,71,390,461,False
2012-06-04,21,12502,40,225,265,False
2012-06-04,22,12503,41,127,168,False
2012-06-04,23,12504,8,78,86,False
2012-06-05,0,12505,6,28,34,False
2012-06-05,1,12506,2,18,20,False
2012-06-05,2,12507,0,8,8,False
2012-06-05,3,12508,0,5,5,False
2012-06-05,4,12509,1,4,5,False
2012-06-05,5,12510,1,35,36,False
2012-06-05,6,12511,7,177,184,False
2012-06-05,7,12512,29,540,569,False
2012-06-05,8,12513,30,680,710,False
2012-06-05,9,12514,50,285,335,False
2012-06-05,10,12515,58,118,176,False
2012-06-05,11,12516,65,162,227,False
2012-06-05,12,12517,45,202,247,False
2012-06-05,13,12518,66,201,267,False
2012-06-05,14,12519,82,194,276,False
2012-06-05,15,12520,54,218,272,False
2012-06-05,16,12521,91,382,473,False
2012-06-05,17,12522,86,764,850,False
2012-06-05,18,12523,111,679,790,False
2012-06-05,19,12524,68,445,513,False
2012-06-05,20,12525,44,371,415,False
2012-06-05,21,12526,30,253,283,False
2012-06-05,22,12527,22,171,193,False
2012-06-05,23,12528,20,93,113,False
2012-06-06,0,12529,3,46,49,False
2012-06-06,1,12530,6,21,27,False
2012-06-06,2,12531,4,7,11,False
2012-06-06,3,12532,0,8,8,False
2012-06-06,4,12533,3,7,10,False
2012-06-06,5,12534,1,37,38,False
2012-06-06,6,12535,7,165,172,False
2012-06-06,7,12536,16,531,547,False
2012-06-06,8,12537,31,637,668,False
2012-06-06,9,12538,35,268,303,False
2012-06-06,10,12539,55,148,203,False
2012-06-06,11,12540,65,161,226,False
2012-06-06,12,12541,80,235,315,False
2012-06-06,13,12542,73,230,303,False
2012-06-06,14,12543,111,191,302,False
2012-06-06,15,12544,75,225,300,False
2012-06-06,16,12545,107,345,452,False
2012-06-06,17,12546,72,652,724,False
2012-06-06,18,12547,94,688,782,False
2012-06-06,19,12548,52,486,538,False
2012-06-06,20,12549,59,349,408,False
2012-06-06,21,12550,38,260,298,False
2012-06-06,22,12551,27,221,248,False
2012-06-06,23,12552,13,110,123,False
2012-06-07,0,12553,9,50,59,False
2012-06-07,1,12554,5,17,22,False
2012-06-07,2,12555,0,12,12,False
2012-06-07,3,12556,0,5,5,False
2012-06-07,4,12557,0,6,6,False
2012-06-07,5,12558,0,34,34,False
2012-06-07,6,12559,5,165,170,False
2012-06-07,7,12560,20,506,526,False
2012-06-07,8,12561,20,661,681,False
2012-06-07,9,12562,37,300,337,False
2012-06-07,10,12563,56,154,210,False
2012-06-07,11,12564,67,170,237,False
2012-06-07,12,12565,62,274,336,False
2012-06-07,13,12566,65,250,315,False
2012-06-07,14,12567,67,198,265,False
2012-06-07,15,12568,99,234,333,False
2012-06-07,16,12569,77,389,466,False
2012-06-07,17,12570,91,778,869,False
2012-06-07,18,12571,110,703,813,False
2012-06-07,19,12572,65,537,602,False
2012-06-07,20,12573,76,402,478,False
2012-06-07,21,12574,30,283,313,False
2012-06-07,22,12575,35,193,228,False
2012-06-07,23,12576,42,135,177,False
2012-06-08,0,12577,18,59,77,False
2012-06-08,1,12578,4,25,29,False
2012-06-08,2,12579,2,17,19,False
2012-06-08,3,12580,0,8,8,False
2012-06-08,4,12581,1,9,10,False
2012-06-08,5,12582,1,28,29,False
2012-06-08,6,12583,8,131,139,False
2012-06-08,7,12584,19,409,428,False
2012-06-08,8,12585,37,663,700,False
2012-06-08,9,12586,47,335,382,False
2012-06-08,10,12587,62,187,249,False
2012-06-08,11,12588,65,199,264,False
2012-06-08,12,12589,89,280,369,False
2012-06-08,13,12590,129,287,416,False
2012-06-08,14,12591,128,245,373,False
2012-06-08,15,12592,98,299,397,False
2012-06-08,16,12593,111,412,523,False
2012-06-08,17,12594,114,679,793,False
2012-06-08,18,12595,147,576,723,False
2012-06-08,19,12596,95,460,555,False
2012-06-08,20,12597,117,291,408,False
2012-06-08,21,12598,83,256,339,False
2012-06-08,22,12599,61,230,291,False
2012-06-08,23,12600,52,163,215,False
2012-06-09,0,12601,54,152,206,False
2012-06-09,1,12602,34,89,123,False
2012-06-09,2,12603,21,68,89,False
2012-06-09,3,12604,12,28,40,False
2012-06-09,4,12605,2,6,8,False
2012-06-09,5,12606,4,15,19,False
2012-06-09,6,12607,17,63,80,False
2012-06-09,7,12608,26,61,87,False
2012-06-09,8,12609,42,202,244,False
2012-06-09,9,12610,99,241,340,False
2012-06-09,10,12611,168,298,466,False
2012-06-09,11,12612,218,351,569,False
2012-06-09,12,12613,196,335,531,False
2012-06-09,13,12614,236,349,585,False
2012-06-09,14,12615,239,354,593,False
2012-06-09,15,12616,218,337,555,False
2012-06-09,16,12617,219,315,534,False
2012-06-09,17,12618,238,257,495,False
2012-06-09,18,12619,175,276,451,False
2012-06-09,19,12620,128,232,360,False
2012-06-09,20,12621,125,238,363,False
2012-06-09,21,12622,105,211,316,False
2012-06-09,22,12623,63,151,214,False
2012-06-09,23,12624,69,161,230,False
2012-06-10,0,12625,33,125,158,False
2012-06-10,1,12626,32,84,116,False
2012-06-10,2,12627,17,56,73,False
2012-06-10,3,12628,6,23,29,False
2012-06-10,4,12629,1,9,10,False
2012-06-10,5,12630,3,10,13,False
2012-06-10,6,12631,3,27,30,False
2012-06-10,7,12632,21,41,62,False
2012-06-10,8,12633,59,122,181,False
2012-06-10,9,12634,91,175,266,False
2012-06-10,10,12635,148,265,413,False
2012-06-10,11,12636,184,315,499,False
2012-06-10,12,12637,173,329,502,False
2012-06-10,13,12638,204,288,492,False
2012-06-10,14,12639,186,314,500,False
2012-06-10,15,12640,159,316,475,False
2012-06-10,16,12641,173,335,508,False
2012-06-10,17,12642,184,337,521,False
2012-06-10,18,12643,164,326,490,False
2012-06-10,19,12644,115,260,375,False
2012-06-10,20,12645,113,250,363,False
2012-06-10,21,12646,83,170,253,False
2012-06-10,22,12647,42,117,159,False
2012-06-10,23,12648,30,80,110,False
2012-06-11,0,12649,8,33,41,False
2012-06-11,1,12650,9,15,24,False
2012-06-11,2,12651,5,12,17,False
2012-06-11,3,12652,2,4,6,False
2012-06-11,4,12653,0,7,7,False
2012-06-11,5,12654,1,36,37,False
2012-06-11,6,12655,8,136,144,False
2012-06-11,7,12656,25,478,503,False
2012-06-11,8,12657,38,613,651,False
2012-06-11,9,12658,57,259,316,False
2012-06-11,10,12659,52,95,147,False
2012-06-11,11,12660,59,143,202,False
2012-06-11,12,12661,63,198,261,False
2012-06-11,13,12662,63,185,248,False
2012-06-11,14,12663,66,193,259,False
2012-06-11,15,12664,72,187,259,False
2012-06-11,16,12665,87,340,427,False
2012-06-11,17,12666,85,715,800,False
2012-06-11,18,12667,105,726,831,False
2012-06-11,19,12668,89,507,596,False
2012-06-11,20,12669,61,333,394,False
2012-06-11,21,12670,32,218,250,False
2012-06-11,22,12671,22,142,164,False
2012-06-11,23,12672,8,72,80,False
2012-06-12,0,12673,2,26,28,False
2012-06-12,1,12674,5,11,16,False
2012-06-12,2,12675,0,6,6,False
2012-06-12,3,12676,3,9,12,False
2012-06-12,4,12677,0,4,4,False
2012-06-12,5,12678,1,28,29,False
2012-06-12,6,12679,6,130,136,False
2012-06-12,7,12680,16,287,303,False
2012-06-12,8,12681,15,598,613,False
2012-06-12,9,12682,31,254,285,False
2012-06-12,10,12683,29,96,125,False
2012-06-12,11,12684,8,57,65,False
2012-06-12,12,12685,19,76,95,False
2012-06-12,13,12686,11,48,59,False
2012-06-12,14,12687,12,48,60,False
2012-06-12,15,12688,22,94,116,False
2012-06-12,16,12689,30,209,239,False
2012-06-12,17,12690,56,625,681,False
2012-06-12,18,12691,57,596,653,False
2012-06-12,19,12692,47,444,491,False
2012-06-12,20,12693,36,350,386,False
2012-06-12,21,12694,41,233,274,False
2012-06-12,22,12695,19,188,207,False
2012-06-12,23,12696,11,78,89,False
2012-06-13,0,12697,7,27,34,False
2012-06-13,1,12698,7,21,28,False
2012-06-13,2,12699,0,4,4,False
2012-06-13,3,12700,1,7,8,False
2012-06-13,4,12701,1,9,10,False
2012-06-13,5,12702,2,38,40,False
2012-06-13,6,12703,6,188,194,False
2012-06-13,7,12704,25,480,505,False
2012-06-13,8,12705,41,672,713,False
2012-06-13,9,12706,54,298,352,False
2012-06-13,10,12707,64,134,198,False
2012-06-13,11,12708,64,182,246,False
2012-06-13,12,12709,93,241,334,False
2012-06-13,13,12710,52,203,255,False
2012-06-13,14,12711,98,222,320,False
2012-06-13,15,12712,65,216,281,False
2012-06-13,16,12713,72,320,392,False
2012-06-13,17,12714,75,782,857,False
2012-06-13,18,12715,104,640,744,False
2012-06-13,19,12716,123,548,671,False
2012-06-13,20,12717,86,362,448,False
2012-06-13,21,12718,79,317,396,False
2012-06-13,22,12719,29,209,238,False
2012-06-13,23,12720,25,128,153,False
2012-06-14,0,12721,3,45,48,False
2012-06-14,1,12722,4,17,21,False
2012-06-14,2,12723,1,8,9,False
2012-06-14,3,12724,1,4,5,False
2012-06-14,4,12725,0,6,6,False
2012-06-14,5,12726,0,40,40,False
2012-06-14,6,12727,12,169,181,False
2012-06-14,7,12728,26,480,506,False
2012-06-14,8,12729,37,682,719,False
2012-06-14,9,12730,45,312,357,False
2012-06-14,10,12731,47,132,179,False
2012-06-14,11,12732,60,168,228,False
2012-06-14,12,12733,55,210,265,False
2012-06-14,13,12734,71,213,284,False
2012-06-14,14,12735,84,214,298,False
2012-06-14,15,12736,111,213,324,False
2012-06-14,16,12737,70,368,438,False
2012-06-14,17,12738,117,750,867,False
2012-06-14,18,12739,107,716,823,False
2012-06-14,19,12740,96,483,579,False
2012-06-14,20,12741,84,351,435,False
2012-06-14,21,12742,67,270,337,False
2012-06-14,22,12743,46,196,242,False
2012-06-14,23,12744,36,136,172,False
2012-06-15,0,12745,26,68,94,False
2012-06-15,1,12746,9,42,51,False
2012-06-15,2,12747,0,15,15,False
2012-06-15,3,12748,2,3,5,False
2012-06-15,4,12749,1,13,14,False
2012-06-15,5,12750,2,31,33,False
2012-06-15,6,12751,9,142,151,False
2012-06-15,7,12752,17,413,430,False
2012-06-15,8,12753,44,609,653,False
2012-06-15,9,12754,58,308,366,False
2012-06-15,10,12755,56,160,216,False
2012-06-15,11,12756,106,180,286,False
2012-06-15,12,12757,111,292,403,False
2012-06-15,13,12758,121,272,393,False
2012-06-15,14,12759,121,255,376,False
2012-06-15,15,12760,107,270,377,False
2012-06-15,16,12761,132,426,558,False
2012-06-15,17,12762,125,698,823,False
2012-06-15,18,12763,121,572,693,False
2012-06-15,19,12764,98,369,467,False
2012-06-15,20,12765,89,296,385,False
2012-06-15,21,12766,83,250,333,False
2012-06-15,22,12767,79,242,321,False
2012-06-15,23,12768,46,176,222,False
2012-06-16,0,12769,25,112,137,False
2012-06-16,1,12770,16,79,95,False
2012-06-16,2,12771,12,55,67,False
2012-06-16,3,12772,8,19,27,False
2012-06-16,4,12773,3,5,8,False
2012-06-16,5,12774,2,21,23,False
2012-06-16,6,12775,11,36,47,False
2012-06-16,7,12776,10,68,78,False
2012-06-16,8,12777,47,157,204,False
2012-06-16,9,12778,88,279,367,False
2012-06-16,10,12779,139,296,435,False
2012-06-16,11,12780,213,353,566,False
2012-06-16,12,12781,254,349,603,False
2012-06-16,13,12782,293,324,617,False
2012-06-16,14,12783,264,309,573,False
2012-06-16,15,12784,295,288,583,False
2012-06-16,16,12785,238,304,542,False
2012-06-16,17,12786,244,349,593,False
2012-06-16,18,12787,256,315,571,False
2012-06-16,19,12788,184,277,461,False
2012-06-16,20,12789,123,229,352,False
2012-06-16,21,12790,98,192,290,False
2012-06-16,22,12791,91,189,280,False
2012-06-16,23,12792,49,134,183,False
2012-06-17,0,12793,31,117,148,False
2012-06-17,1,12794,21,67,88,False
2012-06-17,2,12795,19,55,74,False
2012-06-17,3,12796,6,22,28,False
2012-06-17,4,12797,2,16,18,False
2012-06-17,5,12798,4,13,17,False
2012-06-17,6,12799,7,16,23,False
2012-06-17,7,12800,18,30,48,False
2012-06-17,8,12801,24,95,119,False
2012-06-17,9,12802,91,183,274,False
2012-06-17,10,12803,148,288,436,False
2012-06-17,11,12804,196,350,546,False
2012-06-17,12,12805,260,355,615,False
2012-06-17,13,12806,267,347,614,False
2012-06-17,14,12807,255,327,582,False
2012-06-17,15,12808,203,260,463,False
2012-06-17,16,12809,240,340,580,False
2012-06-17,17,12810,232,361,593,False
2012-06-17,18,12811,203,310,513,False
2012-06-17,19,12812,146,244,390,False
2012-06-17,20,12813,101,201,302,False
2012-06-17,21,12814,76,170,246,False
2012-06-17,22,12815,55,98,153,False
2012-06-17,23,12816,29,79,108,False
2012-06-18,0,12817,12,28,40,False
2012-06-18,1,12818,9,5,14,False
2012-06-18,2,12819,3,6,9,False
2012-06-18,3,12820,1,3,4,False
2012-06-18,4,12821,0,9,9,False
2012-06-18,5,12822,1,22,23,False
2012-06-18,6,12823,0,37,37,False
2012-06-18,7,12824,10,135,145,False
2012-06-18,8,12825,27,447,474,False
2012-06-18,9,12826,28,222,250,False
2012-06-18,10,12827,13,78,91,False
2012-06-18,11,12828,25,96,121,False
2012-06-18,12,12829,29,139,168,False
2012-06-18,13,12830,51,174,225,False
2012-06-18,14,12831,59,160,219,False
2012-06-18,15,12832,61,176,237,False
2012-06-18,16,12833,53,279,332,False
2012-06-18,17,12834,54,669,723,False
2012-06-18,18,12835,47,595,642,False
2012-06-18,19,12836,52,411,463,False
2012-06-18,20,12837,45,317,362,False
2012-06-18,21,12838,35,238,273,False
2012-06-18,22,12839,21,143,164,False
2012-06-18,23,12840,17,57,74,False
2012-06-19,0,12841,5,30,35,False
2012-06-19,1,12842,1,13,14,False
2012-06-19,2,12843,1,14,15,False
2012-06-19,3,12844,1,7,8,False
2012-06-19,4,12845,1,9,10,False
2012-06-19,5,12846,3,34,37,False
2012-06-19,6,12847,9,152,161,False
2012-06-19,7,12848,18,462,480,False
2012-06-19,8,12849,40,633,673,False
2012-06-19,9,12850,40,288,328,False
2012-06-19,10,12851,44,136,180,False
2012-06-19,11,12852,56,174,230,False
2012-06-19,12,12853,70,222,292,False
2012-06-19,13,12854,69,203,272,False
2012-06-19,14,12855,61,166,227,False
2012-06-19,15,12856,72,187,259,False
2012-06-19,16,12857,48,286,334,False
2012-06-19,17,12858,86,725,811,False
2012-06-19,18,12859,91,704,795,False
2012-06-19,19,12860,82,432,514,False
2012-06-19,20,12861,59,399,458,False
2012-06-19,21,12862,37,239,276,False
2012-06-19,22,12863,51,240,291,False
2012-06-19,23,12864,23,102,125,False
2012-06-20,0,12865,5,48,53,False
2012-06-20,1,12866,7,20,27,False
2012-06-20,2,12867,1,5,6,False
2012-06-20,3,12868,2,6,8,False
2012-06-20,4,12869,1,6,7,False
2012-06-20,5,12870,2,37,39,False
2012-06-20,6,12871,9,156,165,False
2012-06-20,7,12872,20,444,464,False
2012-06-20,8,12873,43,600,643,False
2012-06-20,9,12874,40,276,316,False
2012-06-20,10,12875,41,126,167,False
2012-06-20,11,12876,54,134,188,False
2012-06-20,12,12877,30,150,180,False
2012-06-20,13,12878,48,163,211,False
2012-06-20,14,12879,56,134,190,False
2012-06-20,15,12880,36,143,179,False
2012-06-20,16,12881,51,284,335,False
2012-06-20,17,12882,80,611,691,False
2012-06-20,18,12883,81,591,672,False
2012-06-20,19,12884,90,449,539,False
2012-06-20,20,12885,81,326,407,False
2012-06-20,21,12886,42,302,344,False
2012-06-20,22,12887,31,226,257,False
2012-06-20,23,12888,21,102,123,False
2012-06-21,0,12889,16,53,69,False
2012-06-21,1,12890,2,16,18,False
2012-06-21,2,12891,11,7,18,False
2012-06-21,3,12892,3,8,11,False
2012-06-21,4,12893,1,11,12,False
2012-06-21,5,12894,3,37,40,False
2012-06-21,6,12895,3,147,150,False
2012-06-21,7,12896,26,437,463,False
2012-06-21,8,12897,27,563,590,False
2012-06-21,9,12898,32,224,256,False
2012-06-21,10,12899,36,114,150,False
2012-06-21,11,12900,40,121,161,False
2012-06-21,12,12901,33,182,215,False
2012-06-21,13,12902,31,141,172,False
2012-06-21,14,12903,27,149,176,False
2012-06-21,15,12904,40,154,194,False
2012-06-21,16,12905,37,283,320,False
2012-06-21,17,12906,80,535,615,False
2012-06-21,18,12907,78,562,640,False
2012-06-21,19,12908,84,415,499,False
2012-06-21,20,12909,79,357,436,False
2012-06-21,21,12910,55,256,311,False
2012-06-21,22,12911,22,221,243,False
2012-06-21,23,12912,12,134,146,False
2012-06-22,0,12913,16,77,93,False
2012-06-22,1,12914,3,28,31,False
2012-06-22,2,12915,0,12,12,False
2012-06-22,3,12916,1,6,7,False
2012-06-22,4,12917,3,7,10,False
2012-06-22,5,12918,3,35,38,False
2012-06-22,6,12919,4,118,122,False
2012-06-22,7,12920,19,340,359,False
2012-06-22,8,12921,49,564,613,False
2012-06-22,9,12922,55,278,333,False
2012-06-22,10,12923,52,133,185,False
2012-06-22,11,12924,76,160,236,False
2012-06-22,12,12925,63,191,254,False
2012-06-22,13,12926,72,228,300,False
2012-06-22,14,12927,65,198,263,False
2012-06-22,15,12928,72,212,284,False
2012-06-22,16,12929,67,313,380,False
2012-06-22,17,12930,95,551,646,False
2012-06-22,18,12931,62,443,505,False
2012-06-22,19,12932,45,317,362,False
2012-06-22,20,12933,31,171,202,False
2012-06-22,21,12934,40,177,217,False
2012-06-22,22,12935,42,155,197,False
2012-06-22,23,12936,29,145,174,False
2012-06-23,0,12937,14,102,116,False
2012-06-23,1,12938,16,107,123,False
2012-06-23,2,12939,18,75,93,False
2012-06-23,3,12940,10,32,42,False
2012-06-23,4,12941,6,13,19,False
2012-06-23,5,12942,1,11,12,False
2012-06-23,6,12943,10,37,47,False
2012-06-23,7,12944,19,59,78,False
2012-06-23,8,12945,34,133,167,False
2012-06-23,9,12946,85,247,332,False
2012-06-23,10,12947,177,317,494,False
2012-06-23,11,12948,167,349,516,False
2012-06-23,12,12949,203,399,602,False
2012-06-23,13,12950,226,338,564,False
2012-06-23,14,12951,238,371,609,False
2012-06-23,15,12952,217,266,483,False
2012-06-23,16,12953,196,317,513,False
2012-06-23,17,12954,214,316,530,False
2012-06-23,18,12955,194,287,481,False
2012-06-23,19,12956,185,240,425,False
2012-06-23,20,12957,158,228,386,False
2012-06-23,21,12958,99,223,322,False
2012-06-23,22,12959,101,178,279,False
2012-06-23,23,12960,69,156,225,False
2012-06-24,0,12961,31,132,163,False
2012-06-24,1,12962,39,88,127,False
2012-06-24,2,12963,34,80,114,False
2012-06-24,3,12964,19,41,60,False
2012-06-24,4,12965,4,9,13,False
2012-06-24,5,12966,1,7,8,False
2012-06-24,6,12967,6,19,25,False
2012-06-24,7,12968,23,48,71,False
2012-06-24,8,12969,38,103,141,False
2012-06-24,9,12970,63,169,232,False
2012-06-24,10,12971,161,291,452,False
2012-06-24,11,12972,215,291,506,False
2012-06-24,12,12973,227,329,556,False
2012-06-24,13,12974,237,348,585,False
2012-06-24,14,12975,253,298,551,False
2012-06-24,15,12976,197,290,487,False
2012-06-24,16,12977,181,280,461,False
2012-06-24,17,12978,203,329,532,False
2012-06-24,18,12979,186,348,534,False
2012-06-24,19,12980,176,247,423,False
2012-06-24,20,12981,108,224,332,False
2012-06-24,21,12982,76,177,253,False
2012-06-24,22,12983,53,125,178,False
2012-06-24,23,12984,20,67,87,False
2012-06-25,0,12985,31,37,68,False
2012-06-25,1,12986,11,20,31,False
2012-06-25,2,12987,4,10,14,False
2012-06-25,3,12988,1,4,5,False
2012-06-25,4,12989,0,4,4,False
2012-06-25,5,12990,1,42,43,False
2012-06-25,6,12991,11,147,158,False
2012-06-25,7,12992,30,455,485,False
2012-06-25,8,12993,53,555,608,False
2012-06-25,9,12994,37,231,268,False
2012-06-25,10,12995,58,126,184,False
2012-06-25,11,12996,54,127,181,False
2012-06-25,12,12997,74,196,270,False
2012-06-25,13,12998,79,181,260,False
2012-06-25,14,12999,90,161,251,False
2012-06-25,15,13000,65,168,233,False
2012-06-25,16,13001,104,310,414,False
2012-06-25,17,13002,76,757,833,False
2012-06-25,18,13003,100,691,791,False
2012-06-25,19,13004,74,508,582,False
2012-06-25,20,13005,100,375,475,False
2012-06-25,21,13006,50,281,331,False
2012-06-25,22,13007,21,166,187,False
2012-06-25,23,13008,15,88,103,False
2012-06-26,0,13009,8,29,37,False
2012-06-26,1,13010,11,19,30,False
2012-06-26,2,13011,2,7,9,False
2012-06-26,3,13012,2,7,9,False
2012-06-26,4,13013,1,9,10,False
2012-06-26,5,13014,3,36,39,False
2012-06-26,6,13015,12,176,188,False
2012-06-26,7,13016,21,531,552,False
2012-06-26,8,13017,34,622,656,False
2012-06-26,9,13018,30,298,328,False
2012-06-26,10,13019,37,153,190,False
2012-06-26,11,13020,46,189,235,False
2012-06-26,12,13021,80,228,308,False
2012-06-26,13,13022,74,232,306,False
2012-06-26,14,13023,81,186,267,False
2012-06-26,15,13024,88,229,317,False
2012-06-26,16,13025,67,349,416,False
2012-06-26,17,13026,104,796,900,False
2012-06-26,18,13027,105,719,824,False
2012-06-26,19,13028,83,529,612,False
2012-06-26,20,13029,88,417,505,False
2012-06-26,21,13030,61,267,328,False
2012-06-26,22,13031,26,219,245,False
2012-06-26,23,13032,13,118,131,False
2012-06-27,0,13033,15,39,54,False
2012-06-27,1,13034,5,18,23,False
2012-06-27,2,13035,2,12,14,False
2012-06-27,3,13036,1,7,8,False
2012-06-27,4,13037,0,11,11,False
2012-06-27,5,13038,2,34,36,False
2012-06-27,6,13039,7,193,200,False
2012-06-27,7,13040,29,498,527,False
2012-06-27,8,13041,49,638,687,False
2012-06-27,9,13042,29,253,282,False
2012-06-27,10,13043,34,138,172,False
2012-06-27,11,13044,64,145,209,False
2012-06-27,12,13045,77,245,322,False
2012-06-27,13,13046,77,244,321,False
2012-06-27,14,13047,78,192,270,False
2012-06-27,15,13048,61,188,249,False
2012-06-27,16,13049,55,337,392,False
2012-06-27,17,13050,113,730,843,False
2012-06-27,18,13051,85,719,804,False
2012-06-27,19,13052,101,542,643,False
2012-06-27,20,13053,76,369,445,False
2012-06-27,21,13054,54,313,367,False
2012-06-27,22,13055,52,245,297,False
2012-06-27,23,13056,11,148,159,False
2012-06-28,0,13057,2,52,54,False
2012-06-28,1,13058,11,14,25,False
2012-06-28,2,13059,1,12,13,False
2012-06-28,3,13060,1,6,7,False
2012-06-28,4,13061,0,11,11,False
2012-06-28,5,13062,8,39,47,False
2012-06-28,6,13063,8,185,193,False
2012-06-28,7,13064,24,484,508,False
2012-06-28,8,13065,40,577,617,False
2012-06-28,9,13066,33,318,351,False
2012-06-28,10,13067,40,144,184,False
2012-06-28,11,13068,41,170,211,False
2012-06-28,12,13069,49,227,276,False
2012-06-28,13,13070,31,205,236,False
2012-06-28,14,13071,66,188,254,False
2012-06-28,15,13072,24,195,219,False
2012-06-28,16,13073,56,331,387,False
2012-06-28,17,13074,71,634,705,False
2012-06-28,18,13075,100,597,697,False
2012-06-28,19,13076,79,492,571,False
2012-06-28,20,13077,71,399,470,False
2012-06-28,21,13078,89,309,398,False
2012-06-28,22,13079,50,224,274,False
2012-06-28,23,13080,26,145,171,False
2012-06-29,0,13081,24,90,114,False
2012-06-29,1,13082,9,33,42,False
2012-06-29,2,13083,3,15,18,False
2012-06-29,3,13084,3,5,8,False
2012-06-29,4,13085,1,9,10,False
2012-06-29,5,13086,6,39,45,False
2012-06-29,6,13087,15,148,163,False
2012-06-29,7,13088,19,361,380,False
2012-06-29,8,13089,48,576,624,False
2012-06-29,9,13090,39,261,300,False
2012-06-29,10,13091,32,139,171,False
2012-06-29,11,13092,51,137,188,False
2012-06-29,12,13093,53,173,226,False
2012-06-29,13,13094,45,194,239,False
2012-06-29,14,13095,49,184,233,False
2012-06-29,15,13096,47,183,230,False
2012-06-29,16,13097,59,292,351,False
2012-06-29,17,13098,82,457,539,False
2012-06-29,18,13099,50,414,464,False
2012-06-29,19,13100,60,303,363,False
2012-06-29,20,13101,53,255,308,False
2012-06-29,21,13102,41,195,236,False
2012-06-29,22,13103,34,129,163,False
2012-06-29,23,13104,6,42,48,False
2012-06-30,0,13105,4,65,69,False
2012-06-30,1,13106,3,55,58,False
2012-06-30,2,13107,7,54,61,False
2012-06-30,3,13108,3,20,23,False
2012-06-30,4,13109,3,15,18,False
2012-06-30,5,13110,3,7,10,False
2012-06-30,6,13111,6,36,42,False
2012-06-30,7,13112,10,82,92,False
2012-06-30,8,13113,26,168,194,False
2012-06-30,9,13114,41,234,275,False
2012-06-30,10,13115,96,308,404,False
2012-06-30,11,13116,102,350,452,False
2012-06-30,12,13117,143,328,471,False
2012-06-30,13,13118,105,323,428,False
2012-06-30,14,13119,114,295,409,False
2012-06-30,15,13120,117,287,404,False
2012-06-30,16,13121,109,264,373,False
2012-06-30,17,13122,131,231,362,False
2012-06-30,18,13123,91,248,339,False
2012-06-30,19,13124,134,240,374,False
2012-06-30,20,13125,88,204,292,False
2012-06-30,21,13126,48,165,213,False
2012-06-30,22,13127,38,134,172,False
2012-06-30,23,13128,33,119,152,False
2012-07-01,0,13129,27,122,149,False
2012-07-01,1,13130,12,81,93,False
2012-07-01,2,13131,21,69,90,False
2012-07-01,3,13132,6,27,33,False
2012-07-01,4,13133,0,4,4,False
2012-07-01,5,13134,3,7,10,False
2012-07-01,6,13135,8,19,27,False
2012-07-01,7,13136,13,37,50,False
2012-07-01,8,13137,36,106,142,False
2012-07-01,9,13138,51,168,219,False
2012-07-01,10,13139,98,268,366,False
2012-07-01,11,13140,121,256,377,False
2012-07-01,12,13141,114,319,433,False
2012-07-01,13,13142,111,309,420,False
2012-07-01,14,13143,98,346,444,False
2012-07-01,15,13144,101,244,345,False
2012-07-01,16,13145,85,228,313,False
2012-07-01,17,13146,90,323,413,False
2012-07-01,18,13147,95,275,370,False
2012-07-01,19,13148,103,279,382,False
2012-07-01,20,13149,88,244,332,False
2012-07-01,21,13150,77,181,258,False
2012-07-01,22,13151,41,110,151,False
2012-07-01,23,13152,22,88,110,False
2012-07-02,0,13153,12,31,43,False
2012-07-02,1,13154,3,14,17,False
2012-07-02,2,13155,1,14,15,False
2012-07-02,3,13156,0,5,5,False
2012-07-02,4,13157,2,10,12,False
2012-07-02,5,13158,3,37,40,False
2012-07-02,6,13159,4,132,136,False
2012-07-02,7,13160,8,390,398,False
2012-07-02,8,13161,20,548,568,False
2012-07-02,9,13162,56,239,295,False
2012-07-02,10,13163,70,104,174,False
2012-07-02,11,13164,67,134,201,False
2012-07-02,12,13165,74,183,257,False
2012-07-02,13,13166,74,162,236,False
2012-07-02,14,13167,79,151,230,False
2012-07-02,15,13168,59,175,234,False
2012-07-02,16,13169,61,304,365,False
2012-07-02,17,13170,82,665,747,False
2012-07-02,18,13171,72,658,730,False
2012-07-02,19,13172,71,510,581,False
2012-07-02,20,13173,38,357,395,False
2012-07-02,21,13174,17,241,258,False
2012-07-02,22,13175,19,169,188,False
2012-07-02,23,13176,12,90,102,False
2012-07-03,0,13177,9,44,53,False
2012-07-03,1,13178,5,9,14,False
2012-07-03,2,13179,2,8,10,False
2012-07-03,3,13180,0,2,2,False
2012-07-03,4,13181,0,6,6,False
2012-07-03,5,13182,2,33,35,False
2012-07-03,6,13183,5,149,154,False
2012-07-03,7,13184,21,462,483,False
2012-07-03,8,13185,42,604,646,False
2012-07-03,9,13186,46,226,272,False
2012-07-03,10,13187,56,153,209,False
2012-07-03,11,13188,66,151,217,False
2012-07-03,12,13189,74,198,272,False
2012-07-03,13,13190,80,203,283,False
2012-07-03,14,13191,69,241,310,False
2012-07-03,15,13192,71,330,401,False
2012-07-03,16,13193,90,437,527,False
2012-07-03,17,13194,102,620,722,False
2012-07-03,18,13195,85,542,627,False
2012-07-03,19,13196,66,431,497,False
2012-07-03,20,13197,80,296,376,False
2012-07-03,21,13198,36,160,196,False
2012-07-03,22,13199,26,151,177,False
2012-07-03,23,13200,19,152,171,False
2012-07-04,0,13201,19,140,159,False
2012-07-04,1,13202,27,96,123,False
2012-07-04,2,13203,27,66,93,False
2012-07-04,3,13204,9,23,32,False
2012-07-04,4,13205,5,11,16,False
2012-07-04,5,13206,5,14,19,False
2012-07-04,6,13207,9,23,32,False
2012-07-04,7,13208,10,62,72,False
2012-07-04,8,13209,43,110,153,False
2012-07-04,9,13210,90,203,293,False
2012-07-04,10,13211,143,304,447,False
2012-07-04,11,13212,164,321,485,False
2012-07-04,12,13213,164,330,494,False
2012-07-04,13,13214,177,322,499,False
2012-07-04,14,13215,190,357,547,False
2012-07-04,15,13216,155,299,454,False
2012-07-04,16,13217,163,226,389,False
2012-07-04,17,13218,161,253,414,False
2012-07-04,18,13219,159,271,430,False
2012-07-04,19,13220,177,255,432,False
2012-07-04,20,13221,237,314,551,False
2012-07-04,21,13222,222,362,584,False
2012-07-04,22,13223,175,327,502,False
2012-07-04,23,13224,31,152,183,False
2012-07-05,0,13225,17,71,88,False
2012-07-05,1,13226,6,24,30,False
2012-07-05,2,13227,4,14,18,False
2012-07-05,3,13228,2,5,7,False
2012-07-05,4,13229,0,7,7,False
2012-07-05,5,13230,1,28,29,False
2012-07-05,6,13231,3,130,133,False
2012-07-05,7,13232,27,316,343,False
2012-07-05,8,13233,36,514,550,False
2012-07-05,9,13234,47,246,293,False
2012-07-05,10,13235,69,117,186,False
2012-07-05,11,13236,107,137,244,False
2012-07-05,12,13237,88,188,276,False
2012-07-05,13,13238,129,181,310,False
2012-07-05,14,13239,87,154,241,False
2012-07-05,15,13240,71,183,254,False
2012-07-05,16,13241,109,324,433,False
2012-07-05,17,13242,114,575,689,False
2012-07-05,18,13243,96,511,607,False
2012-07-05,19,13244,128,375,503,False
2012-07-05,20,13245,78,243,321,False
2012-07-05,21,13246,91,232,323,False
2012-07-05,22,13247,63,162,225,False
2012-07-05,23,13248,32,99,131,False
2012-07-06,0,13249,39,63,102,False
2012-07-06,1,13250,7,22,29,False
2012-07-06,2,13251,4,13,17,False
2012-07-06,3,13252,1,6,7,False
2012-07-06,4,13253,2,4,6,False
2012-07-06,5,13254,4,31,35,False
2012-07-06,6,13255,4,127,131,False
2012-07-06,7,13256,20,333,353,False
2012-07-06,8,13257,28,557,585,False
2012-07-06,9,13258,55,249,304,False
2012-07-06,10,13259,80,130,210,False
2012-07-06,11,13260,92,141,233,False
2012-07-06,12,13261,111,220,331,False
2012-07-06,13,13262,99,194,293,False
2012-07-06,14,13263,91,184,275,False
2012-07-06,15,13264,79,206,285,False
2012-07-06,16,13265,69,300,369,False
2012-07-06,17,13266,90,486,576,False
2012-07-06,18,13267,106,454,560,False
2012-07-06,19,13268,112,306,418,False
2012-07-06,20,13269,91,245,336,False
2012-07-06,21,13270,77,223,300,False
2012-07-06,22,13271,78,210,288,False
2012-07-06,23,13272,27,137,164,False
2012-07-07,0,13273,35,115,150,False
2012-07-07,1,13274,16,55,71,False
2012-07-07,2,13275,11,47,58,False
2012-07-07,3,13276,12,19,31,False
2012-07-07,4,13277,3,13,16,False
2012-07-07,5,13278,2,12,14,False
2012-07-07,6,13279,4,27,31,False
2012-07-07,7,13280,8,63,71,False
2012-07-07,8,13281,32,120,152,False
2012-07-07,9,13282,69,187,256,False
2012-07-07,10,13283,100,225,325,False
2012-07-07,11,13284,122,245,367,False
2012-07-07,12,13285,124,218,342,False
2012-07-07,13,13286,116,244,360,False
2012-07-07,14,13287,105,203,308,False
2012-07-07,15,13288,113,193,306,False
2012-07-07,16,13289,102,192,294,False
2012-07-07,17,13290,103,176,279,False
2012-07-07,18,13291,83,194,277,False
2012-07-07,19,13292,68,219,287,False
2012-07-07,20,13293,79,197,276,False
2012-07-07,21,13294,51,150,201,False
2012-07-07,22,13295,56,164,220,False
2012-07-07,23,13296,34,114,148,False
2012-07-08,0,13297,22,125,147,False
2012-07-08,1,13298,25,99,124,False
2012-07-08,2,13299,11,59,70,False
2012-07-08,3,13300,1,34,35,False
2012-07-08,4,13301,2,11,13,False
2012-07-08,5,13302,1,5,6,False
2012-07-08,6,13303,5,16,21,False
2012-07-08,7,13304,19,33,52,False
2012-07-08,8,13305,35,95,130,False
2012-07-08,9,13306,70,172,242,False
2012-07-08,10,13307,85,234,319,False
2012-07-08,11,13308,120,269,389,False
2012-07-08,12,13309,105,271,376,False
2012-07-08,13,13310,118,219,337,False
2012-07-08,14,13311,77,235,312,False
2012-07-08,15,13312,80,218,298,False
2012-07-08,16,13313,65,226,291,False
2012-07-08,17,13314,68,202,270,False
2012-07-08,18,13315,54,199,253,False
2012-07-08,19,13316,66,184,250,False
2012-07-08,20,13317,79,206,285,False
2012-07-08,21,13318,58,149,207,False
2012-07-08,22,13319,12,110,122,False
2012-07-08,23,13320,25,98,123,False
2012-07-09,0,13321,6,33,39,False
2012-07-09,1,13322,5,13,18,False
2012-07-09,2,13323,1,4,5,False
2012-07-09,3,13324,0,5,5,False
2012-07-09,4,13325,1,1,2,False
2012-07-09,5,13326,1,27,28,False
2012-07-09,6,13327,6,86,92,False
2012-07-09,7,13328,7,223,230,False
2012-07-09,8,13329,26,429,455,False
2012-07-09,9,13330,38,325,363,False
2012-07-09,10,13331,58,117,175,False
2012-07-09,11,13332,72,144,216,False
2012-07-09,12,13333,61,205,266,False
2012-07-09,13,13334,67,188,255,False
2012-07-09,14,13335,58,184,242,False
2012-07-09,15,13336,66,214,280,False
2012-07-09,16,13337,88,325,413,False
2012-07-09,17,13338,108,741,849,False
2012-07-09,18,13339,82,790,872,False
2012-07-09,19,13340,88,543,631,False
2012-07-09,20,13341,69,378,447,False
2012-07-09,21,13342,33,298,331,False
2012-07-09,22,13343,35,189,224,False
2012-07-09,23,13344,22,109,131,False
2012-07-10,0,13345,16,53,69,False
2012-07-10,1,13346,0,15,15,False
2012-07-10,2,13347,1,15,16,False
2012-07-10,3,13348,0,3,3,False
2012-07-10,4,13349,0,4,4,False
2012-07-10,5,13350,3,39,42,False
2012-07-10,6,13351,4,183,187,False
2012-07-10,7,13352,31,489,520,False
2012-07-10,8,13353,34,615,649,False
2012-07-10,9,13354,47,284,331,False
2012-07-10,10,13355,56,134,190,False
2012-07-10,11,13356,92,157,249,False
2012-07-10,12,13357,69,203,272,False
2012-07-10,13,13358,77,203,280,False
2012-07-10,14,13359,71,171,242,False
2012-07-10,15,13360,77,188,265,False
2012-07-10,16,13361,89,346,435,False
2012-07-10,17,13362,103,769,872,False
2012-07-10,18,13363,70,749,819,False
2012-07-10,19,13364,55,359,414,False
2012-07-10,20,13365,9,75,84,False
2012-07-10,21,13366,7,83,90,False
2012-07-10,22,13367,14,125,139,False
2012-07-10,23,13368,29,74,103,False
2012-07-11,0,13369,6,38,44,False
2012-07-11,1,13370,3,11,14,False
2012-07-11,2,13371,0,5,5,False
2012-07-11,3,13372,0,5,5,False
2012-07-11,4,13373,1,6,7,False
2012-07-11,5,13374,5,36,41,False
2012-07-11,6,13375,17,168,185,False
2012-07-11,7,13376,26,471,497,False
2012-07-11,8,13377,30,644,674,False
2012-07-11,9,13378,30,298,328,False
2012-07-11,10,13379,47,148,195,False
2012-07-11,11,13380,56,173,229,False
2012-07-11,12,13381,69,223,292,False
2012-07-11,13,13382,65,208,273,False
2012-07-11,14,13383,66,175,241,False
2012-07-11,15,13384,56,220,276,False
2012-07-11,16,13385,53,358,411,False
2012-07-11,17,13386,90,740,830,False
2012-07-11,18,13387,79,735,814,False
2012-07-11,19,13388,73,560,633,False
2012-07-11,20,13389,73,410,483,False
2012-07-11,21,13390,69,322,391,False
2012-07-11,22,13391,41,203,244,False
2012-07-11,23,13392,20,132,152,False
2012-07-12,0,13393,1,55,56,False
2012-07-12,1,13394,0,21,21,False
2012-07-12,2,13395,0,9,9,False
2012-07-12,3,13396,0,10,10,False
2012-07-12,4,13397,0,5,5,False
2012-07-12,5,13398,4,40,44,False
2012-07-12,6,13399,7,171,178,False
2012-07-12,7,13400,32,480,512,False
2012-07-12,8,13401,49,653,702,False
2012-07-12,9,13402,42,285,327,False
2012-07-12,10,13403,69,145,214,False
2012-07-12,11,13404,49,166,215,False
2012-07-12,12,13405,71,221,292,False
2012-07-12,13,13406,52,225,277,False
2012-07-12,14,13407,42,167,209,False
2012-07-12,15,13408,63,208,271,False
2012-07-12,16,13409,69,370,439,False
2012-07-12,17,13410,91,704,795,False
2012-07-12,18,13411,86,739,825,False
2012-07-12,19,13412,97,532,629,False
2012-07-12,20,13413,75,439,514,False
2012-07-12,21,13414,44,329,373,False
2012-07-12,22,13415,56,262,318,False
2012-07-12,23,13416,33,178,211,False
2012-07-13,0,13417,19,76,95,False
2012-07-13,1,13418,17,42,59,False
2012-07-13,2,13419,2,15,17,False
2012-07-13,3,13420,2,7,9,False
2012-07-13,4,13421,0,11,11,False
2012-07-13,5,13422,4,30,34,False
2012-07-13,6,13423,7,120,127,False
2012-07-13,7,13424,27,353,380,False
2012-07-13,8,13425,53,660,713,False
2012-07-13,9,13426,70,344,414,False
2012-07-13,10,13427,78,190,268,False
2012-07-13,11,13428,68,220,288,False
2012-07-13,12,13429,125,254,379,False
2012-07-13,13,13430,100,274,374,False
2012-07-13,14,13431,120,249,369,False
2012-07-13,15,13432,92,261,353,False
2012-07-13,16,13433,111,381,492,False
2012-07-13,17,13434,138,697,835,False
2012-07-13,18,13435,108,523,631,False
2012-07-13,19,13436,103,385,488,False
2012-07-13,20,13437,95,294,389,False
2012-07-13,21,13438,76,223,299,False
2012-07-13,22,13439,59,204,263,False
2012-07-13,23,13440,37,175,212,False
2012-07-14,0,13441,35,156,191,False
2012-07-14,1,13442,13,105,118,False
2012-07-14,2,13443,10,91,101,False
2012-07-14,3,13444,9,31,40,False
2012-07-14,4,13445,3,6,9,False
2012-07-14,5,13446,0,5,5,False
2012-07-14,6,13447,6,29,35,False
2012-07-14,7,13448,7,41,48,False
2012-07-14,8,13449,33,118,151,False
2012-07-14,9,13450,82,200,282,False
2012-07-14,10,13451,123,278,401,False
2012-07-14,11,13452,143,296,439,False
2012-07-14,12,13453,181,318,499,False
2012-07-14,13,13454,219,372,591,False
2012-07-14,14,13455,269,363,632,False
2012-07-14,15,13456,243,317,560,False
2012-07-14,16,13457,226,340,566,False
2012-07-14,17,13458,199,259,458,False
2012-07-14,18,13459,108,243,351,False
2012-07-14,19,13460,156,275,431,False
2012-07-14,20,13461,101,255,356,False
2012-07-14,21,13462,69,200,269,False
2012-07-14,22,13463,65,160,225,False
2012-07-14,23,13464,55,156,211,False
2012-07-15,0,13465,40,147,187,False
2012-07-15,1,13466,49,119,168,False
2012-07-15,2,13467,29,86,115,False
2012-07-15,3,13468,15,42,57,False
2012-07-15,4,13469,8,11,19,False
2012-07-15,5,13470,2,7,9,False
2012-07-15,6,13471,6,9,15,False
2012-07-15,7,13472,17,30,47,False
2012-07-15,8,13473,37,96,133,False
2012-07-15,9,13474,58,163,221,False
2012-07-15,10,13475,141,241,382,False
2012-07-15,11,13476,170,281,451,False
2012-07-15,12,13477,153,336,489,False
2012-07-15,13,13478,171,309,480,False
2012-07-15,14,13479,162,314,476,False
2012-07-15,15,13480,182,307,489,False
2012-07-15,16,13481,152,343,495,False
2012-07-15,17,13482,122,314,436,False
2012-07-15,18,13483,84,228,312,False
2012-07-15,19,13484,109,203,312,False
2012-07-15,20,13485,95,199,294,False
2012-07-15,21,13486,59,164,223,False
2012-07-15,22,13487,34,96,130,False
2012-07-15,23,13488,25,66,91,False
2012-07-16,0,13489,11,32,43,False
2012-07-16,1,13490,1,10,11,False
2012-07-16,2,13491,4,11,15,False
2012-07-16,3,13492,2,4,6,False
2012-07-16,4,13493,1,11,12,False
2012-07-16,5,13494,10,40,50,False
2012-07-16,6,13495,8,132,140,False
2012-07-16,7,13496,24,459,483,False
2012-07-16,8,13497,48,619,667,False
2012-07-16,9,13498,51,297,348,False
2012-07-16,10,13499,69,117,186,False
2012-07-16,11,13500,57,125,182,False
2012-07-16,12,13501,79,158,237,False
2012-07-16,13,13502,63,176,239,False
2012-07-16,14,13503,53,159,212,False
2012-07-16,15,13504,61,176,237,False
2012-07-16,16,13505,77,309,386,False
2012-07-16,17,13506,86,669,755,False
2012-07-16,18,13507,97,697,794,False
2012-07-16,19,13508,92,503,595,False
2012-07-16,20,13509,66,388,454,False
2012-07-16,21,13510,45,283,328,False
2012-07-16,22,13511,56,228,284,False
2012-07-16,23,13512,27,139,166,False
2012-07-17,0,13513,10,43,53,False
2012-07-17,1,13514,4,21,25,False
2012-07-17,2,13515,1,6,7,False
2012-07-17,3,13516,0,3,3,False
2012-07-17,4,13517,0,7,7,False
2012-07-17,5,13518,7,31,38,False
2012-07-17,6,13519,16,197,213,False
2012-07-17,7,13520,26,500,526,False
2012-07-17,8,13521,43,618,661,False
2012-07-17,9,13522,32,288,320,False
2012-07-17,10,13523,37,122,159,False
2012-07-17,11,13524,60,146,206,False
2012-07-17,12,13525,80,174,254,False
2012-07-17,13,13526,53,168,221,False
2012-07-17,14,13527,54,160,214,False
2012-07-17,15,13528,57,187,244,False
2012-07-17,16,13529,64,317,381,False
2012-07-17,17,13530,95,675,770,False
2012-07-17,18,13531,60,712,772,False
2012-07-17,19,13532,69,478,547,False
2012-07-17,20,13533,52,375,427,False
2012-07-17,21,13534,50,283,333,False
2012-07-17,22,13535,29,215,244,False
2012-07-17,23,13536,22,139,161,False
2012-07-18,0,13537,8,45,53,False
2012-07-18,1,13538,2,14,16,False
2012-07-18,2,13539,3,5,8,False
2012-07-18,3,13540,2,2,4,False
2012-07-18,4,13541,0,6,6,False
2012-07-18,5,13542,5,41,46,False
2012-07-18,6,13543,10,152,162,False
2012-07-18,7,13544,23,472,495,False
2012-07-18,8,13545,55,624,679,False
2012-07-18,9,13546,44,253,297,False
2012-07-18,10,13547,39,99,138,False
2012-07-18,11,13548,47,136,183,False
2012-07-18,12,13549,36,166,202,False
2012-07-18,13,13550,49,154,203,False
2012-07-18,14,13551,54,116,170,False
2012-07-18,15,13552,42,152,194,False
2012-07-18,16,13553,34,190,224,False
2012-07-18,17,13554,35,335,370,False
2012-07-18,18,13555,63,580,643,False
2012-07-18,19,13556,78,438,516,False
2012-07-18,20,13557,56,310,366,False
2012-07-18,21,13558,53,266,319,False
2012-07-18,22,13559,42,246,288,False
2012-07-18,23,13560,19,112,131,False
2012-07-19,0,13561,16,50,66,False
2012-07-19,1,13562,6,19,25,False
2012-07-19,2,13563,0,7,7,False
2012-07-19,3,13564,1,4,5,False
2012-07-19,4,13565,0,8,8,False
2012-07-19,5,13566,5,35,40,False
2012-07-19,6,13567,8,144,152,False
2012-07-19,7,13568,23,450,473,False
2012-07-19,8,13569,32,625,657,False
2012-07-19,9,13570,36,282,318,False
2012-07-19,10,13571,41,157,198,False
2012-07-19,11,13572,54,162,216,False
2012-07-19,12,13573,59,215,274,False
2012-07-19,13,13574,74,180,254,False
2012-07-19,14,13575,46,151,197,False
2012-07-19,15,13576,66,226,292,False
2012-07-19,16,13577,70,288,358,False
2012-07-19,17,13578,93,678,771,False
2012-07-19,18,13579,93,684,777,False
2012-07-19,19,13580,53,480,533,False
2012-07-19,20,13581,65,440,505,False
2012-07-19,21,13582,38,294,332,False
2012-07-19,22,13583,6,62,68,False
2012-07-19,23,13584,3,62,65,False
2012-07-20,0,13585,2,32,34,False
2012-07-20,1,13586,2,9,11,False
2012-07-20,2,13587,5,14,19,False
2012-07-20,3,13588,7,29,36,False
2012-07-20,4,13589,3,6,9,False
2012-07-20,5,13590,2,40,42,False
2012-07-20,6,13591,3,123,126,False
2012-07-20,7,13592,14,346,360,False
2012-07-20,8,13593,39,652,691,False
2012-07-20,9,13594,45,328,373,False
2012-07-20,10,13595,51,182,233,False
2012-07-20,11,13596,51,161,212,False
2012-07-20,12,13597,41,233,274,False
2012-07-20,13,13598,20,136,156,False
2012-07-20,14,13599,53,176,229,False
2012-07-20,15,13600,47,169,216,False
2012-07-20,16,13601,70,366,436,False
2012-07-20,17,13602,95,620,715,False
2012-07-20,18,13603,73,549,622,False
2012-07-20,19,13604,44,358,402,False
2012-07-20,20,13605,35,216,251,False
2012-07-20,21,13606,14,108,122,False
2012-07-20,22,13607,13,122,135,False
2012-07-20,23,13608,18,148,166,False
2012-07-21,0,13609,11,92,103,False
2012-07-21,1,13610,10,62,72,False
2012-07-21,2,13611,5,55,60,False
2012-07-21,3,13612,7,18,25,False
2012-07-21,4,13613,11,5,16,False
2012-07-21,5,13614,7,10,17,False
2012-07-21,6,13615,3,12,15,False
2012-07-21,7,13616,8,29,37,False
2012-07-21,8,13617,18,94,112,False
2012-07-21,9,13618,32,175,207,False
2012-07-21,10,13619,49,219,268,False
2012-07-21,11,13620,80,225,305,False
2012-07-21,12,13621,156,301,457,False
2012-07-21,13,13622,106,248,354,False
2012-07-21,14,13623,121,222,343,False
2012-07-21,15,13624,148,232,380,False
2012-07-21,16,13625,130,196,326,False
2012-07-21,17,13626,92,149,241,False
2012-07-21,18,13627,51,126,177,False
2012-07-21,19,13628,67,171,238,False
2012-07-21,20,13629,51,163,214,False
2012-07-21,21,13630,29,134,163,False
2012-07-21,22,13631,40,140,180,False
2012-07-21,23,13632,32,117,149,False
2012-07-22,0,13633,17,96,113,False
2012-07-22,1,13634,31,99,130,False
2012-07-22,2,13635,32,90,122,False
2012-07-22,3,13636,13,30,43,False
2012-07-22,4,13637,6,10,16,False
2012-07-22,5,13638,0,6,6,False
2012-07-22,6,13639,5,14,19,False
2012-07-22,7,13640,13,25,38,False
2012-07-22,8,13641,31,122,153,False
2012-07-22,9,13642,79,179,258,False
2012-07-22,10,13643,114,265,379,False
2012-07-22,11,13644,191,314,505,False
2012-07-22,12,13645,178,326,504,False
2012-07-22,13,13646,238,388,626,False
2012-07-22,14,13647,256,360,616,False
2012-07-22,15,13648,254,370,624,False
2012-07-22,16,13649,245,383,628,False
2012-07-22,17,13650,188,368,556,False
2012-07-22,18,13651,173,342,515,False
2012-07-22,19,13652,180,342,522,False
2012-07-22,20,13653,124,254,378,False
2012-07-22,21,13654,88,257,345,False
2012-07-22,22,13655,55,136,191,False
2012-07-22,23,13656,33,90,123,False
2012-07-23,0,13657,11,36,47,False
2012-07-23,1,13658,7,20,27,False
2012-07-23,2,13659,3,14,17,False
2012-07-23,3,13660,0,2,2,False
2012-07-23,4,13661,0,8,8,False
2012-07-23,5,13662,3,48,51,False
2012-07-23,6,13663,9,148,157,False
2012-07-23,7,13664,17,404,421,False
2012-07-23,8,13665,47,691,738,False
2012-07-23,9,13666,57,288,345,False
2012-07-23,10,13667,63,137,200,False
2012-07-23,11,13668,69,129,198,False
2012-07-23,12,13669,109,205,314,False
2012-07-23,13,13670,64,176,240,False
2012-07-23,14,13671,82,189,271,False
2012-07-23,15,13672,76,205,281,False
2012-07-23,16,13673,111,346,457,False
2012-07-23,17,13674,87,760,847,False
2012-07-23,18,13675,69,672,741,False
2012-07-23,19,13676,94,488,582,False
2012-07-23,20,13677,56,347,403,False
2012-07-23,21,13678,45,251,296,False
2012-07-23,22,13679,40,169,209,False
2012-07-23,23,13680,16,98,114,False
2012-07-24,0,13681,12,52,64,False
2012-07-24,1,13682,7,10,17,False
2012-07-24,2,13683,6,10,16,False
2012-07-24,3,13684,1,5,6,False
2012-07-24,4,13685,0,6,6,False
2012-07-24,5,13686,5,45,50,False
2012-07-24,6,13687,17,173,190,False
2012-07-24,7,13688,24,492,516,False
2012-07-24,8,13689,49,694,743,False
2012-07-24,9,13690,40,299,339,False
2012-07-24,10,13691,62,156,218,False
2012-07-24,11,13692,45,156,201,False
2012-07-24,12,13693,60,169,229,False
2012-07-24,13,13694,73,200,273,False
2012-07-24,14,13695,48,196,244,False
2012-07-24,15,13696,73,212,285,False
2012-07-24,16,13697,86,369,455,False
2012-07-24,17,13698,94,775,869,False
2012-07-24,18,13699,110,767,877,False
2012-07-24,19,13700,109,523,632,False
2012-07-24,20,13701,85,438,523,False
2012-07-24,21,13702,53,325,378,False
2012-07-24,22,13703,43,226,269,False
2012-07-24,23,13704,38,154,192,False
2012-07-25,0,13705,9,57,66,False
2012-07-25,1,13706,2,26,28,False
2012-07-25,2,13707,1,11,12,False
2012-07-25,3,13708,1,11,12,False
2012-07-25,4,13709,0,4,4,False
2012-07-25,5,13710,5,54,59,False
2012-07-25,6,13711,11,179,190,False
2012-07-25,7,13712,34,473,507,False
2012-07-25,8,13713,43,745,788,False
2012-07-25,9,13714,65,277,342,False
2012-07-25,10,13715,68,163,231,False
2012-07-25,11,13716,79,202,281,False
2012-07-25,12,13717,77,233,310,False
2012-07-25,13,13718,81,231,312,False
2012-07-25,14,13719,88,159,247,False
2012-07-25,15,13720,94,223,317,False
2012-07-25,16,13721,91,393,484,False
2012-07-25,17,13722,130,783,913,False
2012-07-25,18,13723,104,787,891,False
2012-07-25,19,13724,116,582,698,False
2012-07-25,20,13725,106,461,567,False
2012-07-25,21,13726,71,326,397,False
2012-07-25,22,13727,55,223,278,False
2012-07-25,23,13728,52,187,239,False
2012-07-26,0,13729,27,65,92,False
2012-07-26,1,13730,6,23,29,False
2012-07-26,2,13731,5,16,21,False
2012-07-26,3,13732,0,8,8,False
2012-07-26,4,13733,0,4,4,False
2012-07-26,5,13734,2,40,42,False
2012-07-26,6,13735,16,165,181,False
2012-07-26,7,13736,17,478,495,False
2012-07-26,8,13737,49,680,729,False
2012-07-26,9,13738,55,289,344,False
2012-07-26,10,13739,79,143,222,False
2012-07-26,11,13740,69,143,212,False
2012-07-26,12,13741,73,206,279,False
2012-07-26,13,13742,53,189,242,False
2012-07-26,14,13743,62,151,213,False
2012-07-26,15,13744,65,173,238,False
2012-07-26,16,13745,62,312,374,False
2012-07-26,17,13746,110,628,738,False
2012-07-26,18,13747,73,615,688,False
2012-07-26,19,13748,80,534,614,False
2012-07-26,20,13749,47,399,446,False
2012-07-26,21,13750,35,236,271,False
2012-07-26,22,13751,33,201,234,False
2012-07-26,23,13752,18,127,145,False
2012-07-27,0,13753,14,83,97,False
2012-07-27,1,13754,12,42,54,False
2012-07-27,2,13755,8,18,26,False
2012-07-27,3,13756,3,9,12,False
2012-07-27,4,13757,3,5,8,False
2012-07-27,5,13758,3,34,37,False
2012-07-27,6,13759,10,129,139,False
2012-07-27,7,13760,13,397,410,False
2012-07-27,8,13761,34,642,676,False
2012-07-27,9,13762,34,329,363,False
2012-07-27,10,13763,85,146,231,False
2012-07-27,11,13764,67,184,251,False
2012-07-27,12,13765,92,207,299,False
2012-07-27,13,13766,83,231,314,False
2012-07-27,14,13767,105,221,326,False
2012-07-27,15,13768,81,242,323,False
2012-07-27,16,13769,80,419,499,False
2012-07-27,17,13770,101,598,699,False
2012-07-27,18,13771,100,522,622,False
2012-07-27,19,13772,93,423,516,False
2012-07-27,20,13773,85,269,354,False
2012-07-27,21,13774,71,189,260,False
2012-07-27,22,13775,48,151,199,False
2012-07-27,23,13776,34,155,189,False
2012-07-28,0,13777,21,170,191,False
2012-07-28,1,13778,11,69,80,False
2012-07-28,2,13779,14,76,90,False
2012-07-28,3,13780,10,33,43,False
2012-07-28,4,13781,1,10,11,False
2012-07-28,5,13782,4,10,14,False
2012-07-28,6,13783,10,40,50,False
2012-07-28,7,13784,18,58,76,False
2012-07-28,8,13785,36,127,163,False
2012-07-28,9,13786,110,227,337,False
2012-07-28,10,13787,129,266,395,False
2012-07-28,11,13788,162,295,457,False
2012-07-28,12,13789,157,330,487,False
2012-07-28,13,13790,173,325,498,False
2012-07-28,14,13791,186,308,494,False
2012-07-28,15,13792,206,291,497,False
2012-07-28,16,13793,208,279,487,False
2012-07-28,17,13794,199,280,479,False
2012-07-28,18,13795,151,330,481,False
2012-07-28,19,13796,115,223,338,False
2012-07-28,20,13797,79,154,233,False
2012-07-28,21,13798,94,206,300,False
2012-07-28,22,13799,88,188,276,False
2012-07-28,23,13800,52,156,208,False
2012-07-29,0,13801,59,129,188,False
2012-07-29,1,13802,49,109,158,False
2012-07-29,2,13803,33,79,112,False
2012-07-29,3,13804,18,37,55,False
2012-07-29,4,13805,2,11,13,False
2012-07-29,5,13806,3,14,17,False
2012-07-29,6,13807,6,12,18,False
2012-07-29,7,13808,4,36,40,False
2012-07-29,8,13809,37,90,127,False
2012-07-29,9,13810,64,162,226,False
2012-07-29,10,13811,123,258,381,False
2012-07-29,11,13812,183,326,509,False
2012-07-29,12,13813,154,357,511,False
2012-07-29,13,13814,181,302,483,False
2012-07-29,14,13815,231,291,522,False
2012-07-29,15,13816,195,306,501,False
2012-07-29,16,13817,191,330,521,False
2012-07-29,17,13818,164,367,531,False
2012-07-29,18,13819,117,302,419,False
2012-07-29,19,13820,143,300,443,False
2012-07-29,20,13821,75,228,303,False
2012-07-29,21,13822,72,199,271,False
2012-07-29,22,13823,31,117,148,False
2012-07-29,23,13824,18,82,100,False
2012-07-30,0,13825,12,46,58,False
2012-07-30,1,13826,4,15,19,False
2012-07-30,2,13827,2,6,8,False
2012-07-30,3,13828,0,3,3,False
2012-07-30,4,13829,0,5,5,False
2012-07-30,5,13830,4,43,47,False
2012-07-30,6,13831,6,155,161,False
2012-07-30,7,13832,14,455,469,False
2012-07-30,8,13833,31,720,751,False
2012-07-30,9,13834,34,259,293,False
2012-07-30,10,13835,54,135,189,False
2012-07-30,11,13836,69,146,215,False
2012-07-30,12,13837,77,201,278,False
2012-07-30,13,13838,57,169,226,False
2012-07-30,14,13839,87,167,254,False
2012-07-30,15,13840,51,185,236,False
2012-07-30,16,13841,88,337,425,False
2012-07-30,17,13842,62,765,827,False
2012-07-30,18,13843,77,735,812,False
2012-07-30,19,13844,81,584,665,False
2012-07-30,20,13845,78,384,462,False
2012-07-30,21,13846,71,251,322,False
2012-07-30,22,13847,47,183,230,False
2012-07-30,23,13848,34,116,150,False
2012-07-31,0,13849,11,27,38,False
2012-07-31,1,13850,3,18,21,False
2012-07-31,2,13851,0,8,8,False
2012-07-31,3,13852,1,5,6,False
2012-07-31,4,13853,0,6,6,False
2012-07-31,5,13854,5,40,45,False
2012-07-31,6,13855,2,192,194,False
2012-07-31,7,13856,21,492,513,False
2012-07-31,8,13857,30,730,760,False
2012-07-31,9,13858,31,302,333,False
2012-07-31,10,13859,73,154,227,False
2012-07-31,11,13860,54,170,224,False
2012-07-31,12,13861,50,198,248,False
2012-07-31,13,13862,69,219,288,False
2012-07-31,14,13863,72,188,260,False
2012-07-31,15,13864,29,115,144,False
2012-07-31,16,13865,66,336,402,False
2012-07-31,17,13866,94,726,820,False
2012-07-31,18,13867,99,758,857,False
2012-07-31,19,13868,90,524,614,False
2012-07-31,20,13869,55,397,452,False
2012-07-31,21,13870,60,292,352,False
2012-07-31,22,13871,33,224,257,False
2012-07-31,23,13872,20,127,147,False
2012-08-01,0,13873,3,44,47,False
2012-08-01,1,13874,5,28,33,False
2012-08-01,2,13875,0,13,13,False
2012-08-01,3,13876,0,7,7,False
2012-08-01,4,13877,1,3,4,False
2012-08-01,5,13878,3,46,49,False
2012-08-01,6,13879,6,179,185,False
2012-08-01,7,13880,19,468,487,False
2012-08-01,8,13881,32,649,681,False
2012-08-01,9,13882,34,316,350,False
2012-08-01,10,13883,61,175,236,False
2012-08-01,11,13884,54,180,234,False
2012-08-01,12,13885,75,209,284,False
2012-08-01,13,13886,59,221,280,False
2012-08-01,14,13887,88,175,263,False
2012-08-01,15,13888,89,206,295,False
2012-08-01,16,13889,93,386,479,False
2012-08-01,17,13890,103,734,837,False
2012-08-01,18,13891,105,786,891,False
2012-08-01,19,13892,88,564,652,False
2012-08-01,20,13893,65,448,513,False
2012-08-01,21,13894,36,284,320,False
2012-08-01,22,13895,37,251,288,False
2012-08-01,23,13896,18,134,152,False
2012-08-02,0,13897,8,55,63,False
2012-08-02,1,13898,6,36,42,False
2012-08-02,2,13899,3,8,11,False
2012-08-02,3,13900,0,6,6,False
2012-08-02,4,13901,0,9,9,False
2012-08-02,5,13902,4,37,41,False
2012-08-02,6,13903,6,177,183,False
2012-08-02,7,13904,21,452,473,False
2012-08-02,8,13905,21,718,739,False
2012-08-02,9,13906,31,312,343,False
2012-08-02,10,13907,51,130,181,False
2012-08-02,11,13908,59,167,226,False
2012-08-02,12,13909,56,230,286,False
2012-08-02,13,13910,98,212,310,False
2012-08-02,14,13911,54,171,225,False
2012-08-02,15,13912,68,202,270,False
2012-08-02,16,13913,71,335,406,False
2012-08-02,17,13914,90,775,865,False
2012-08-02,18,13915,86,681,767,False
2012-08-02,19,13916,98,509,607,False
2012-08-02,20,13917,51,376,427,False
2012-08-02,21,13918,41,301,342,False
2012-08-02,22,13919,35,227,262,False
2012-08-02,23,13920,25,152,177,False
2012-08-03,0,13921,15,56,71,False
2012-08-03,1,13922,11,32,43,False
2012-08-03,2,13923,0,14,14,False
2012-08-03,3,13924,1,5,6,False
2012-08-03,4,13925,1,11,12,False
2012-08-03,5,13926,2,35,37,False
2012-08-03,6,13927,5,158,163,False
2012-08-03,7,13928,25,396,421,False
2012-08-03,8,13929,32,636,668,False
2012-08-03,9,13930,69,327,396,False
2012-08-03,10,13931,82,167,249,False
2012-08-03,11,13932,77,186,263,False
2012-08-03,12,13933,95,243,338,False
2012-08-03,13,13934,98,247,345,False
2012-08-03,14,13935,102,229,331,False
2012-08-03,15,13936,112,268,380,False
2012-08-03,16,13937,112,380,492,False
2012-08-03,17,13938,95,646,741,False
2012-08-03,18,13939,98,573,671,False
2012-08-03,19,13940,81,388,469,False
2012-08-03,20,13941,89,300,389,False
2012-08-03,21,13942,54,224,278,False
2012-08-03,22,13943,46,156,202,False
2012-08-03,23,13944,26,170,196,False
2012-08-04,0,13945,24,137,161,False
2012-08-04,1,13946,23,99,122,False
2012-08-04,2,13947,20,64,84,False
2012-08-04,3,13948,11,19,30,False
2012-08-04,4,13949,2,11,13,False
2012-08-04,5,13950,1,16,17,False
2012-08-04,6,13951,12,37,49,False
2012-08-04,7,13952,18,49,67,False
2012-08-04,8,13953,49,132,181,False
2012-08-04,9,13954,61,217,278,False
2012-08-04,10,13955,108,288,396,False
2012-08-04,11,13956,155,315,470,False
2012-08-04,12,13957,222,325,547,False
2012-08-04,13,13958,195,332,527,False
2012-08-04,14,13959,183,289,472,False
2012-08-04,15,13960,205,284,489,False
2012-08-04,16,13961,197,253,450,False
2012-08-04,17,13962,179,313,492,False
2012-08-04,18,13963,169,321,490,False
2012-08-04,19,13964,133,264,397,False
2012-08-04,20,13965,117,195,312,False
2012-08-04,21,13966,96,193,289,False
2012-08-04,22,13967,104,165,269,False
2012-08-04,23,13968,61,161,222,False
2012-08-05,0,13969,32,121,153,False
2012-08-05,1,13970,8,79,87,False
2012-08-05,2,13971,5,68,73,False
2012-08-05,3,13972,9,32,41,False
2012-08-05,4,13973,3,11,14,False
2012-08-05,5,13974,1,18,19,False
2012-08-05,6,13975,7,12,19,False
2012-08-05,7,13976,18,50,68,False
2012-08-05,8,13977,27,81,108,False
2012-08-05,9,13978,61,168,229,False
2012-08-05,10,13979,111,253,364,False
2012-08-05,11,13980,155,282,437,False
2012-08-05,12,13981,161,330,491,False
2012-08-05,13,13982,208,315,523,False
2012-08-05,14,13983,161,365,526,False
2012-08-05,15,13984,164,286,450,False
2012-08-05,16,13985,143,278,421,False
2012-08-05,17,13986,122,260,382,False
2012-08-05,18,13987,75,154,229,False
2012-08-05,19,13988,46,139,185,False
2012-08-05,20,13989,53,140,193,False
2012-08-05,21,13990,51,157,208,False
2012-08-05,22,13991,57,100,157,False
2012-08-05,23,13992,29,58,87,False
2012-08-06,0,13993,9,24,33,False
2012-08-06,1,13994,1,10,11,False
2012-08-06,2,13995,0,5,5,False
2012-08-06,3,13996,0,5,5,False
2012-08-06,4,13997,3,8,11,False
2012-08-06,5,13998,2,23,25,False
2012-08-06,6,13999,4,137,141,False
2012-08-06,7,14000,14,393,407,False
2012-08-06,8,14001,27,578,605,False
2012-08-06,9,14002,28,248,276,False
2012-08-06,10,14003,54,159,213,False
2012-08-06,11,14004,108,152,260,False
2012-08-06,12,14005,72,213,285,False
2012-08-06,13,14006,85,204,289,False
2012-08-06,14,14007,99,188,287,False
2012-08-06,15,14008,91,183,274,False
2012-08-06,16,14009,88,363,451,False
2012-08-06,17,14010,112,746,858,False
2012-08-06,18,14011,100,743,843,False
2012-08-06,19,14012,109,531,640,False
2012-08-06,20,14013,89,368,457,False
2012-08-06,21,14014,72,245,317,False
2012-08-06,22,14015,50,157,207,False
2012-08-06,23,14016,16,97,113,False
2012-08-07,0,14017,15,32,47,False
2012-08-07,1,14018,2,16,18,False
2012-08-07,2,14019,6,7,13,False
2012-08-07,3,14020,0,6,6,False
2012-08-07,4,14021,2,7,9,False
2012-08-07,5,14022,3,33,36,False
2012-08-07,6,14023,3,176,179,False
2012-08-07,7,14024,21,481,502,False
2012-08-07,8,14025,41,664,705,False
2012-08-07,9,14026,44,283,327,False
2012-08-07,10,14027,89,161,250,False
2012-08-07,11,14028,84,130,214,False
2012-08-07,12,14029,86,197,283,False
2012-08-07,13,14030,68,185,253,False
2012-08-07,14,14031,76,185,261,False
2012-08-07,15,14032,100,206,306,False
2012-08-07,16,14033,101,344,445,False
2012-08-07,17,14034,125,743,868,False
2012-08-07,18,14035,103,711,814,False
2012-08-07,19,14036,104,506,610,False
2012-08-07,20,14037,74,374,448,False
2012-08-07,21,14038,70,247,317,False
2012-08-07,22,14039,43,181,224,False
2012-08-07,23,14040,18,120,138,False
2012-08-08,0,14041,12,46,58,False
2012-08-08,1,14042,3,20,23,False
2012-08-08,2,14043,1,5,6,False
2012-08-08,3,14044,1,6,7,False
2012-08-08,4,14045,1,6,7,False
2012-08-08,5,14046,3,40,43,False
2012-08-08,6,14047,4,169,173,False
2012-08-08,7,14048,24,458,482,False
2012-08-08,8,14049,48,689,737,False
2012-08-08,9,14050,33,308,341,False
2012-08-08,10,14051,63,151,214,False
2012-08-08,11,14052,80,159,239,False
2012-08-08,12,14053,63,217,280,False
2012-08-08,13,14054,101,212,313,False
2012-08-08,14,14055,63,173,236,False
2012-08-08,15,14056,110,168,278,False
2012-08-08,16,14057,113,328,441,False
2012-08-08,17,14058,107,751,858,False
2012-08-08,18,14059,117,745,862,False
2012-08-08,19,14060,119,567,686,False
2012-08-08,20,14061,76,424,500,False
2012-08-08,21,14062,70,311,381,False
2012-08-08,22,14063,35,198,233,False
2012-08-08,23,14064,16,120,136,False
2012-08-09,0,14065,16,51,67,False
2012-08-09,1,14066,5,23,28,False
2012-08-09,2,14067,2,12,14,False
2012-08-09,3,14068,1,5,6,False
2012-08-09,4,14069,0,10,10,False
2012-08-09,5,14070,4,37,41,False
2012-08-09,6,14071,5,162,167,False
2012-08-09,7,14072,24,451,475,False
2012-08-09,8,14073,28,670,698,False
2012-08-09,9,14074,54,299,353,False
2012-08-09,10,14075,72,133,205,False
2012-08-09,11,14076,94,166,260,False
2012-08-09,12,14077,85,192,277,False
2012-08-09,13,14078,80,201,281,False
2012-08-09,14,14079,86,161,247,False
2012-08-09,15,14080,63,204,267,False
2012-08-09,16,14081,97,320,417,False
2012-08-09,17,14082,111,699,810,False
2012-08-09,18,14083,78,733,811,False
2012-08-09,19,14084,90,533,623,False
2012-08-09,20,14085,91,387,478,False
2012-08-09,21,14086,50,286,336,False
2012-08-09,22,14087,41,218,259,False
2012-08-09,23,14088,19,137,156,False
2012-08-10,0,14089,17,68,85,False
2012-08-10,1,14090,6,35,41,False
2012-08-10,2,14091,6,14,20,False
2012-08-10,3,14092,3,6,9,False
2012-08-10,4,14093,0,7,7,False
2012-08-10,5,14094,4,29,33,False
2012-08-10,6,14095,3,41,44,False
2012-08-10,7,14096,5,128,133,False
2012-08-10,8,14097,7,112,119,False
2012-08-10,9,14098,21,199,220,False
2012-08-10,10,14099,27,166,193,False
2012-08-10,11,14100,73,178,251,False
2012-08-10,12,14101,75,240,315,False
2012-08-10,13,14102,66,224,290,False
2012-08-10,14,14103,71,236,307,False
2012-08-10,15,14104,100,224,324,False
2012-08-10,16,14105,96,371,467,False
2012-08-10,17,14106,111,619,730,False
2012-08-10,18,14107,88,552,640,False
2012-08-10,19,14108,98,394,492,False
2012-08-10,20,14109,55,315,370,False
2012-08-10,21,14110,50,236,286,False
2012-08-10,22,14111,50,168,218,False
2012-08-10,23,14112,33,159,192,False
2012-08-11,0,14113,38,142,180,False
2012-08-11,1,14114,32,84,116,False
2012-08-11,2,14115,19,66,85,False
2012-08-11,3,14116,2,19,21,False
2012-08-11,4,14117,3,7,10,False
2012-08-11,5,14118,2,9,11,False
2012-08-11,6,14119,5,18,23,False
2012-08-11,7,14120,8,54,62,False
2012-08-11,8,14121,30,132,162,False
2012-08-11,9,14122,54,217,271,False
2012-08-11,10,14123,125,282,407,False
2012-08-11,11,14124,203,296,499,False
2012-08-11,12,14125,214,332,546,False
2012-08-11,13,14126,228,341,569,False
2012-08-11,14,14127,248,290,538,False
2012-08-11,15,14128,246,316,562,False
2012-08-11,16,14129,227,304,531,False
2012-08-11,17,14130,220,292,512,False
2012-08-11,18,14131,107,193,300,False
2012-08-11,19,14132,97,178,275,False
2012-08-11,20,14133,31,129,160,False
2012-08-11,21,14134,26,102,128,False
2012-08-11,22,14135,40,128,168,False
2012-08-11,23,14136,42,121,163,False
2012-08-12,0,14137,24,96,120,False
2012-08-12,1,14138,21,92,113,False
2012-08-12,2,14139,19,67,86,False
2012-08-12,3,14140,11,37,48,False
2012-08-12,4,14141,2,8,10,False
2012-08-12,5,14142,1,9,10,False
2012-08-12,6,14143,2,14,16,False
2012-08-12,7,14144,9,30,39,False
2012-08-12,8,14145,35,84,119,False
2012-08-12,9,14146,64,153,217,False
2012-08-12,10,14147,88,240,328,False
2012-08-12,11,14148,167,282,449,False
2012-08-12,12,14149,163,342,505,False
2012-08-12,13,14150,178,365,543,False
2012-08-12,14,14151,213,366,579,False
2012-08-12,15,14152,235,342,577,False
2012-08-12,16,14153,213,300,513,False
2012-08-12,17,14154,186,319,505,False
2012-08-12,18,14155,164,327,491,False
2012-08-12,19,14156,148,317,465,False
2012-08-12,20,14157,96,204,300,False
2012-08-12,21,14158,78,142,220,False
2012-08-12,22,14159,40,141,181,False
2012-08-12,23,14160,25,85,110,False
2012-08-13,0,14161,14,33,47,False
2012-08-13,1,14162,3,11,14,False
2012-08-13,2,14163,1,8,9,False
2012-08-13,3,14164,1,5,6,False
2012-08-13,4,14165,0,11,11,False
2012-08-13,5,14166,3,33,36,False
2012-08-13,6,14167,4,155,159,False
2012-08-13,7,14168,11,425,436,False
2012-08-13,8,14169,25,648,673,False
2012-08-13,9,14170,40,265,305,False
2012-08-13,10,14171,88,111,199,False
2012-08-13,11,14172,94,151,245,False
2012-08-13,12,14173,96,180,276,False
2012-08-13,13,14174,79,175,254,False
2012-08-13,14,14175,85,163,248,False
2012-08-13,15,14176,80,194,274,False
2012-08-13,16,14177,116,348,464,False
2012-08-13,17,14178,102,716,818,False
2012-08-13,18,14179,103,709,812,False
2012-08-13,19,14180,88,467,555,False
2012-08-13,20,14181,58,374,432,False
2012-08-13,21,14182,44,246,290,False
2012-08-13,22,14183,44,148,192,False
2012-08-13,23,14184,28,100,128,False
2012-08-14,0,14185,12,48,60,False
2012-08-14,1,14186,8,19,27,False
2012-08-14,2,14187,2,9,11,False
2012-08-14,3,14188,0,3,3,False
2012-08-14,4,14189,0,5,5,False
2012-08-14,5,14190,1,35,36,False
2012-08-14,6,14191,1,63,64,False
2012-08-14,7,14192,1,178,179,False
2012-08-14,8,14193,27,591,618,False
2012-08-14,9,14194,48,354,402,False
2012-08-14,10,14195,53,155,208,False
2012-08-14,11,14196,69,127,196,False
2012-08-14,12,14197,93,207,300,False
2012-08-14,13,14198,83,203,286,False
2012-08-14,14,14199,80,175,255,False
2012-08-14,15,14200,84,199,283,False
2012-08-14,16,14201,95,363,458,False
2012-08-14,17,14202,78,734,812,False
2012-08-14,18,14203,97,757,854,False
2012-08-14,19,14204,94,533,627,False
2012-08-14,20,14205,65,371,436,False
2012-08-14,21,14206,56,252,308,False
2012-08-14,22,14207,28,161,189,False
2012-08-14,23,14208,53,114,167,False
2012-08-15,0,14209,8,52,60,False
2012-08-15,1,14210,6,31,37,False
2012-08-15,2,14211,1,7,8,False
2012-08-15,3,14212,1,10,11,False
2012-08-15,4,14213,0,4,4,False
2012-08-15,5,14214,4,35,39,False
2012-08-15,6,14215,12,160,172,False
2012-08-15,7,14216,25,467,492,False
2012-08-15,8,14217,40,642,682,False
2012-08-15,9,14218,57,310,367,False
2012-08-15,10,14219,70,163,233,False
2012-08-15,11,14220,80,155,235,False
2012-08-15,12,14221,77,230,307,False
2012-08-15,13,14222,88,206,294,False
2012-08-15,14,14223,94,161,255,False
2012-08-15,15,14224,70,196,266,False
2012-08-15,16,14225,91,340,431,False
2012-08-15,17,14226,102,749,851,False
2012-08-15,18,14227,80,768,848,False
2012-08-15,19,14228,124,525,649,False
2012-08-15,20,14229,72,355,427,False
2012-08-15,21,14230,49,266,315,False
2012-08-15,22,14231,29,197,226,False
2012-08-15,23,14232,18,120,138,False
2012-08-16,0,14233,13,63,76,False
2012-08-16,1,14234,3,18,21,False
2012-08-16,2,14235,0,15,15,False
2012-08-16,3,14236,0,4,4,False
2012-08-16,4,14237,2,3,5,False
2012-08-16,5,14238,7,30,37,False
2012-08-16,6,14239,3,162,165,False
2012-08-16,7,14240,16,448,464,False
2012-08-16,8,14241,33,649,682,False
2012-08-16,9,14242,41,296,337,False
2012-08-16,10,14243,78,121,199,False
2012-08-16,11,14244,83,191,274,False
2012-08-16,12,14245,96,247,343,False
2012-08-16,13,14246,81,219,300,False
2012-08-16,14,14247,72,176,248,False
2012-08-16,15,14248,63,197,260,False
2012-08-16,16,14249,79,340,419,False
2012-08-16,17,14250,130,767,897,False
2012-08-16,18,14251,109,723,832,False
2012-08-16,19,14252,119,558,677,False
2012-08-16,20,14253,100,414,514,False
2012-08-16,21,14254,83,273,356,False
2012-08-16,22,14255,69,185,254,False
2012-08-16,23,14256,58,168,226,False
2012-08-17,0,14257,21,67,88,False
2012-08-17,1,14258,16,38,54,False
2012-08-17,2,14259,4,15,19,False
2012-08-17,3,14260,0,6,6,False
2012-08-17,4,14261,0,9,9,False
2012-08-17,5,14262,2,34,36,False
2012-08-17,6,14263,6,151,157,False
2012-08-17,7,14264,11,368,379,False
2012-08-17,8,14265,43,625,668,False
2012-08-17,9,14266,58,320,378,False
2012-08-17,10,14267,82,149,231,False
2012-08-17,11,14268,98,205,303,False
2012-08-17,12,14269,110,255,365,False
2012-08-17,13,14270,103,254,357,False
2012-08-17,14,14271,128,200,328,False
2012-08-17,15,14272,127,256,383,False
2012-08-17,16,14273,116,372,488,False
2012-08-17,17,14274,144,647,791,False
2012-08-17,18,14275,108,561,669,False
2012-08-17,19,14276,88,403,491,False
2012-08-17,20,14277,97,262,359,False
2012-08-17,21,14278,57,198,255,False
2012-08-17,22,14279,43,170,213,False
2012-08-17,23,14280,21,100,121,False
2012-08-18,0,14281,6,99,105,False
2012-08-18,1,14282,14,78,92,False
2012-08-18,2,14283,4,39,43,False
2012-08-18,3,14284,7,23,30,False
2012-08-18,4,14285,5,8,13,False
2012-08-18,5,14286,2,7,9,False
2012-08-18,6,14287,4,23,27,False
2012-08-18,7,14288,12,52,64,False
2012-08-18,8,14289,28,161,189,False
2012-08-18,9,14290,81,211,292,False
2012-08-18,10,14291,166,314,480,False
2012-08-18,11,14292,180,356,536,False
2012-08-18,12,14293,266,388,654,False
2012-08-18,13,14294,289,355,644,False
2012-08-18,14,14295,242,356,598,False
2012-08-18,15,14296,250,346,596,False
2012-08-18,16,14297,287,354,641,False
2012-08-18,17,14298,256,379,635,False
2012-08-18,18,14299,225,329,554,False
2012-08-18,19,14300,164,324,488,False
2012-08-18,20,14301,99,242,341,False
2012-08-18,21,14302,90,248,338,False
2012-08-18,22,14303,90,171,261,False
2012-08-18,23,14304,60,175,235,False
2012-08-19,0,14305,44,143,187,False
2012-08-19,1,14306,29,102,131,False
2012-08-19,2,14307,16,103,119,False
2012-08-19,3,14308,21,34,55,False
2012-08-19,4,14309,4,22,26,False
2012-08-19,5,14310,3,8,11,False
2012-08-19,6,14311,5,15,20,False
2012-08-19,7,14312,12,29,41,False
2012-08-19,8,14313,34,90,124,False
2012-08-19,9,14314,86,184,270,False
2012-08-19,10,14315,138,287,425,False
2012-08-19,11,14316,83,189,272,False
2012-08-19,12,14317,112,186,298,False
2012-08-19,13,14318,50,112,162,False
2012-08-19,14,14319,41,108,149,False
2012-08-19,15,14320,89,187,276,False
2012-08-19,16,14321,97,259,356,False
2012-08-19,17,14322,76,267,343,False
2012-08-19,18,14323,86,291,377,False
2012-08-19,19,14324,72,269,341,False
2012-08-19,20,14325,61,213,274,False
2012-08-19,21,14326,36,154,190,False
2012-08-19,22,14327,6,50,56,False
2012-08-19,23,14328,7,39,46,False
2012-08-20,0,14329,1,25,26,False
2012-08-20,1,14330,0,10,10,False
2012-08-20,2,14331,0,5,5,False
2012-08-20,3,14332,0,3,3,False
2012-08-20,4,14333,0,7,7,False
2012-08-20,5,14334,2,35,37,False
2012-08-20,6,14335,6,155,161,False
2012-08-20,7,14336,15,427,442,False
2012-08-20,8,14337,37,618,655,False
2012-08-20,9,14338,55,302,357,False
2012-08-20,10,14339,69,124,193,False
2012-08-20,11,14340,90,151,241,False
2012-08-20,12,14341,66,216,282,False
2012-08-20,13,14342,97,194,291,False
2012-08-20,14,14343,87,188,275,False
2012-08-20,15,14344,102,207,309,False
2012-08-20,16,14345,103,357,460,False
2012-08-20,17,14346,83,810,893,False
2012-08-20,18,14347,89,726,815,False
2012-08-20,19,14348,33,266,299,False
2012-08-20,20,14349,30,231,261,False
2012-08-20,21,14350,26,219,245,False
2012-08-20,22,14351,25,136,161,False
2012-08-20,23,14352,10,92,102,False
2012-08-21,0,14353,7,52,59,False
2012-08-21,1,14354,11,22,33,False
2012-08-21,2,14355,1,7,8,False
2012-08-21,3,14356,0,3,3,False
2012-08-21,4,14357,0,4,4,False
2012-08-21,5,14358,4,30,34,False
2012-08-21,6,14359,5,164,169,False
2012-08-21,7,14360,19,500,519,False
2012-08-21,8,14361,27,696,723,False
2012-08-21,9,14362,47,281,328,False
2012-08-21,10,14363,58,120,178,False
2012-08-21,11,14364,61,195,256,False
2012-08-21,12,14365,79,226,305,False
2012-08-21,13,14366,76,255,331,False
2012-08-21,14,14367,110,192,302,False
2012-08-21,15,14368,76,226,302,False
2012-08-21,16,14369,109,358,467,False
2012-08-21,17,14370,92,786,878,False
2012-08-21,18,14371,93,532,625,False
2012-08-21,19,14372,56,420,476,False
2012-08-21,20,14373,62,296,358,False
2012-08-21,21,14374,41,239,280,False
2012-08-21,22,14375,24,208,232,False
2012-08-21,23,14376,23,113,136,False
2012-08-22,0,14377,9,46,55,False
2012-08-22,1,14378,1,20,21,False
2012-08-22,2,14379,7,10,17,False
2012-08-22,3,14380,0,7,7,False
2012-08-22,4,14381,1,7,8,False
2012-08-22,5,14382,2,38,40,False
2012-08-22,6,14383,12,175,187,False
2012-08-22,7,14384,16,537,553,False
2012-08-22,8,14385,37,703,740,False
2012-08-22,9,14386,41,335,376,False
2012-08-22,10,14387,66,159,225,False
2012-08-22,11,14388,71,196,267,False
2012-08-22,12,14389,59,253,312,False
2012-08-22,13,14390,74,242,316,False
2012-08-22,14,14391,82,184,266,False
2012-08-22,15,14392,94,222,316,False
2012-08-22,16,14393,102,358,460,False
2012-08-22,17,14394,72,711,783,False
2012-08-22,18,14395,91,592,683,False
2012-08-22,19,14396,56,524,580,False
2012-08-22,20,14397,59,332,391,False
2012-08-22,21,14398,60,291,351,False
2012-08-22,22,14399,55,226,281,False
2012-08-22,23,14400,27,113,140,False
2012-08-23,0,14401,9,51,60,False
2012-08-23,1,14402,10,15,25,False
2012-08-23,2,14403,9,11,20,False
2012-08-23,3,14404,3,6,9,False
2012-08-23,4,14405,0,6,6,False
2012-08-23,5,14406,1,36,37,False
2012-08-23,6,14407,14,178,192,False
2012-08-23,7,14408,18,463,481,False
2012-08-23,8,14409,45,662,707,False
2012-08-23,9,14410,58,354,412,False
2012-08-23,10,14411,76,157,233,False
2012-08-23,11,14412,86,192,278,False
2012-08-23,12,14413,97,235,332,False
2012-08-23,13,14414,93,253,346,False
2012-08-23,14,14415,114,191,305,False
2012-08-23,15,14416,104,201,305,False
2012-08-23,16,14417,121,344,465,False
2012-08-23,17,14418,111,709,820,False
2012-08-23,18,14419,130,811,941,False
2012-08-23,19,14420,96,537,633,False
2012-08-23,20,14421,70,404,474,False
2012-08-23,21,14422,53,276,329,False
2012-08-23,22,14423,21,177,198,False
2012-08-23,23,14424,24,133,157,False
2012-08-24,0,14425,27,84,111,False
2012-08-24,1,14426,5,37,42,False
2012-08-24,2,14427,1,15,16,False
2012-08-24,3,14428,2,6,8,False
2012-08-24,4,14429,2,6,8,False
2012-08-24,5,14430,1,37,38,False
2012-08-24,6,14431,9,142,151,False
2012-08-24,7,14432,13,412,425,False
2012-08-24,8,14433,41,703,744,False
2012-08-24,9,14434,58,331,389,False
2012-08-24,10,14435,78,184,262,False
2012-08-24,11,14436,69,212,281,False
2012-08-24,12,14437,95,276,371,False
2012-08-24,13,14438,79,272,351,False
2012-08-24,14,14439,109,229,338,False
2012-08-24,15,14440,99,251,350,False
2012-08-24,16,14441,101,414,515,False
2012-08-24,17,14442,117,695,812,False
2012-08-24,18,14443,109,627,736,False
2012-08-24,19,14444,106,430,536,False
2012-08-24,20,14445,66,297,363,False
2012-08-24,21,14446,58,248,306,False
2012-08-24,22,14447,42,209,251,False
2012-08-24,23,14448,38,140,178,False
2012-08-25,0,14449,21,114,135,False
2012-08-25,1,14450,15,100,115,False
2012-08-25,2,14451,18,61,79,False
2012-08-25,3,14452,7,31,38,False
2012-08-25,4,14453,3,9,12,False
2012-08-25,5,14454,4,10,14,False
2012-08-25,6,14455,5,25,30,False
2012-08-25,7,14456,14,88,102,False
2012-08-25,8,14457,29,133,162,False
2012-08-25,9,14458,60,228,288,False
2012-08-25,10,14459,148,294,442,False
2012-08-25,11,14460,143,314,457,False
2012-08-25,12,14461,217,367,584,False
2012-08-25,13,14462,186,331,517,False
2012-08-25,14,14463,150,332,482,False
2012-08-25,15,14464,79,154,233,False
2012-08-25,16,14465,174,260,434,False
2012-08-25,17,14466,132,271,403,False
2012-08-25,18,14467,122,261,383,False
2012-08-25,19,14468,97,257,354,False
2012-08-25,20,14469,65,176,241,False
2012-08-25,21,14470,60,148,208,False
2012-08-25,22,14471,46,136,182,False
2012-08-25,23,14472,34,124,158,False
2012-08-26,0,14473,23,111,134,False
2012-08-26,1,14474,18,116,134,False
2012-08-26,2,14475,12,104,116,False
2012-08-26,3,14476,11,42,53,False
2012-08-26,4,14477,5,11,16,False
2012-08-26,5,14478,3,13,16,False
2012-08-26,6,14479,5,16,21,False
2012-08-26,7,14480,11,23,34,False
2012-08-26,8,14481,21,112,133,False
2012-08-26,9,14482,67,196,263,False
2012-08-26,10,14483,127,258,385,False
2012-08-26,11,14484,150,332,482,False
2012-08-26,12,14485,225,401,626,False
2012-08-26,13,14486,166,375,541,False
2012-08-26,14,14487,125,252,377,False
2012-08-26,15,14488,132,259,391,False
2012-08-26,16,14489,57,116,173,False
2012-08-26,17,14490,61,172,233,False
2012-08-26,18,14491,77,187,264,False
2012-08-26,19,14492,80,212,292,False
2012-08-26,20,14493,40,171,211,False
2012-08-26,21,14494,26,140,166,False
2012-08-26,22,14495,20,94,114,False
2012-08-26,23,14496,21,59,80,False
2012-08-27,0,14497,4,28,32,False
2012-08-27,1,14498,3,4,7,False
2012-08-27,2,14499,0,8,8,False
2012-08-27,3,14500,1,3,4,False
2012-08-27,4,14501,1,11,12,False
2012-08-27,5,14502,4,32,36,False
2012-08-27,6,14503,4,141,145,False
2012-08-27,7,14504,15,418,433,False
2012-08-27,8,14505,29,670,699,False
2012-08-27,9,14506,40,302,342,False
2012-08-27,10,14507,63,143,206,False
2012-08-27,11,14508,47,182,229,False
2012-08-27,12,14509,69,214,283,False
2012-08-27,13,14510,77,211,288,False
2012-08-27,14,14511,66,180,246,False
2012-08-27,15,14512,77,205,282,False
2012-08-27,16,14513,77,367,444,False
2012-08-27,17,14514,101,744,845,False
2012-08-27,18,14515,83,751,834,False
2012-08-27,19,14516,74,499,573,False
2012-08-27,20,14517,50,366,416,False
2012-08-27,21,14518,39,239,278,False
2012-08-27,22,14519,30,131,161,False
2012-08-27,23,14520,35,79,114,False
2012-08-28,0,14521,9,29,38,False
2012-08-28,1,14522,4,17,21,False
2012-08-28,2,14523,2,13,15,False
2012-08-28,3,14524,0,4,4,False
2012-08-28,4,14525,2,6,8,False
2012-08-28,5,14526,3,39,42,False
2012-08-28,6,14527,3,144,147,False
2012-08-28,7,14528,14,255,269,False
2012-08-28,8,14529,25,668,693,False
2012-08-28,9,14530,44,351,395,False
2012-08-28,10,14531,39,165,204,False
2012-08-28,11,14532,47,171,218,False
2012-08-28,12,14533,56,241,297,False
2012-08-28,13,14534,56,232,288,False
2012-08-28,14,14535,72,179,251,False
2012-08-28,15,14536,59,258,317,False
2012-08-28,16,14537,84,396,480,False
2012-08-28,17,14538,90,774,864,False
2012-08-28,18,14539,82,736,818,False
2012-08-28,19,14540,82,515,597,False
2012-08-28,20,14541,87,348,435,False
2012-08-28,21,14542,38,276,314,False
2012-08-28,22,14543,20,196,216,False
2012-08-28,23,14544,17,92,109,False
2012-08-29,0,14545,8,39,47,False
2012-08-29,1,14546,2,12,14,False
2012-08-29,2,14547,2,4,6,False
2012-08-29,3,14548,0,9,9,False
2012-08-29,4,14549,2,8,10,False
2012-08-29,5,14550,3,37,40,False
2012-08-29,6,14551,6,175,181,False
2012-08-29,7,14552,23,531,554,False
2012-08-29,8,14553,28,780,808,False
2012-08-29,9,14554,40,308,348,False
2012-08-29,10,14555,34,144,178,False
2012-08-29,11,14556,67,186,253,False
2012-08-29,12,14557,79,281,360,False
2012-08-29,13,14558,68,232,300,False
2012-08-29,14,14559,87,214,301,False
2012-08-29,15,14560,96,242,338,False
2012-08-29,16,14561,104,389,493,False
2012-08-29,17,14562,108,762,870,False
2012-08-29,18,14563,119,693,812,False
2012-08-29,19,14564,120,523,643,False
2012-08-29,20,14565,49,378,427,False
2012-08-29,21,14566,48,265,313,False
2012-08-29,22,14567,50,185,235,False
2012-08-29,23,14568,34,123,157,False
2012-08-30,0,14569,14,51,65,False
2012-08-30,1,14570,6,17,23,False
2012-08-30,2,14571,3,14,17,False
2012-08-30,3,14572,0,5,5,False
2012-08-30,4,14573,4,4,8,False
2012-08-30,5,14574,2,33,35,False
2012-08-30,6,14575,8,155,163,False
2012-08-30,7,14576,31,501,532,False
2012-08-30,8,14577,53,701,754,False
2012-08-30,9,14578,57,339,396,False
2012-08-30,10,14579,73,161,234,False
2012-08-30,11,14580,85,191,276,False
2012-08-30,12,14581,73,221,294,False
2012-08-30,13,14582,76,214,290,False
2012-08-30,14,14583,74,199,273,False
2012-08-30,15,14584,99,239,338,False
2012-08-30,16,14585,77,405,482,False
2012-08-30,17,14586,93,751,844,False
2012-08-30,18,14587,109,744,853,False
2012-08-30,19,14588,78,532,610,False
2012-08-30,20,14589,68,403,471,False
2012-08-30,21,14590,32,275,307,False
2012-08-30,22,14591,38,253,291,False
2012-08-30,23,14592,19,133,152,False
2012-08-31,0,14593,13,69,82,False
2012-08-31,1,14594,8,24,32,False
2012-08-31,2,14595,9,11,20,False
2012-08-31,3,14596,3,2,5,False
2012-08-31,4,14597,0,7,7,False
2012-08-31,5,14598,2,27,29,False
2012-08-31,6,14599,7,101,108,False
2012-08-31,7,14600,21,400,421,False
2012-08-31,8,14601,36,654,690,False
2012-08-31,9,14602,61,337,398,False
2012-08-31,10,14603,59,197,256,False
2012-08-31,11,14604,88,221,309,False
2012-08-31,12,14605,120,290,410,False
2012-08-31,13,14606,97,271,368,False
2012-08-31,14,14607,112,324,436,False
2012-08-31,15,14608,109,417,526,False
2012-08-31,16,14609,111,417,528,False
2012-08-31,17,14610,129,488,617,False
2012-08-31,18,14611,87,459,546,False
2012-08-31,19,14612,91,361,452,False
2012-08-31,20,14613,102,254,356,False
2012-08-31,21,14614,71,232,303,False
2012-08-31,22,14615,65,212,277,False
2012-08-31,23,14616,32,142,174,False
2012-09-01,0,14617,22,146,168,False
2012-09-01,1,14618,11,68,79,False
2012-09-01,2,14619,8,61,69,False
2012-09-01,3,14620,6,29,35,False
2012-09-01,4,14621,3,9,12,False
2012-09-01,5,14622,2,20,22,False
2012-09-01,6,14623,13,23,36,False
2012-09-01,7,14624,8,58,66,False
2012-09-01,8,14625,28,134,162,False
2012-09-01,9,14626,62,175,237,False
2012-09-01,10,14627,128,289,417,False
2012-09-01,11,14628,219,273,492,False
2012-09-01,12,14629,187,284,471,False
2012-09-01,13,14630,237,267,504,False
2012-09-01,14,14631,240,274,514,False
2012-09-01,15,14632,257,306,563,False
2012-09-01,16,14633,209,253,462,False
2012-09-01,17,14634,205,258,463,False
2012-09-01,18,14635,184,258,442,False
2012-09-01,19,14636,157,235,392,False
2012-09-01,20,14637,67,140,207,False
2012-09-01,21,14638,21,83,104,False
2012-09-01,22,14639,21,57,78,False
2012-09-01,23,14640,57,88,145,False
2012-09-02,0,14641,27,72,99,False
2012-09-02,1,14642,15,58,73,False
2012-09-02,2,14643,28,56,84,False
2012-09-02,3,14644,9,33,42,False
2012-09-02,4,14645,7,15,22,False
2012-09-02,5,14646,2,10,12,False
2012-09-02,6,14647,2,13,15,False
2012-09-02,7,14648,13,29,42,False
2012-09-02,8,14649,30,99,129,False
2012-09-02,9,14650,88,144,232,False
2012-09-02,10,14651,158,230,388,False
2012-09-02,11,14652,226,263,489,False
2012-09-02,12,14653,248,297,545,False
2012-09-02,13,14654,263,230,493,False
2012-09-02,14,14655,249,208,457,False
2012-09-02,15,14656,179,176,355,False
2012-09-02,16,14657,222,252,474,False
2012-09-02,17,14658,219,284,503,False
2012-09-02,18,14659,227,273,500,False
2012-09-02,19,14660,140,152,292,False
2012-09-02,20,14661,63,41,104,False
2012-09-02,21,14662,79,92,171,False
2012-09-02,22,14663,66,100,166,False
2012-09-02,23,14664,53,70,123,False
2012-09-03,0,14665,42,62,104,False
2012-09-03,1,14666,18,37,55,False
2012-09-03,2,14667,10,30,40,False
2012-09-03,3,14668,6,22,28,False
2012-09-03,4,14669,6,5,11,False
2012-09-03,5,14670,1,3,4,False
2012-09-03,6,14671,3,12,15,False
2012-09-03,7,14672,6,37,43,False
2012-09-03,8,14673,36,91,127,False
2012-09-03,9,14674,71,158,229,False
2012-09-03,10,14675,135,224,359,False
2012-09-03,11,14676,187,272,459,False
2012-09-03,12,14677,191,352,543,False
2012-09-03,13,14678,209,357,566,False
2012-09-03,14,14679,163,349,512,False
2012-09-03,15,14680,168,281,449,False
2012-09-03,16,14681,165,335,500,False
2012-09-03,17,14682,181,317,498,False
2012-09-03,18,14683,145,337,482,False
2012-09-03,19,14684,73,301,374,False
2012-09-03,20,14685,78,183,261,False
2012-09-03,21,14686,42,142,184,False
2012-09-03,22,14687,17,104,121,False
2012-09-03,23,14688,12,58,70,False
2012-09-04,0,14689,10,19,29,False
2012-09-04,1,14690,15,9,24,False
2012-09-04,2,14691,1,4,5,False
2012-09-04,3,14692,1,9,10,False
2012-09-04,4,14693,0,8,8,False
2012-09-04,5,14694,1,37,38,False
2012-09-04,6,14695,7,165,172,False
2012-09-04,7,14696,13,480,493,False
2012-09-04,8,14697,15,617,632,False
2012-09-04,9,14698,30,293,323,False
2012-09-04,10,14699,42,130,172,False
2012-09-04,11,14700,39,159,198,False
2012-09-04,12,14701,54,233,287,False
2012-09-04,13,14702,72,203,275,False
2012-09-04,14,14703,72,202,274,False
2012-09-04,15,14704,68,224,292,False
2012-09-04,16,14705,61,397,458,False
2012-09-04,17,14706,110,746,856,False
2012-09-04,18,14707,94,745,839,False
2012-09-04,19,14708,50,502,552,False
2012-09-04,20,14709,47,338,385,False
2012-09-04,21,14710,28,240,268,False
2012-09-04,22,14711,25,154,179,False
2012-09-04,23,14712,12,83,95,False
2012-09-05,0,14713,10,27,37,False
2012-09-05,1,14714,2,11,13,False
2012-09-05,2,14715,0,9,9,False
2012-09-05,3,14716,0,4,4,False
2012-09-05,4,14717,2,3,5,False
2012-09-05,5,14718,1,39,40,False
2012-09-05,6,14719,7,203,210,False
2012-09-05,7,14720,11,489,500,False
2012-09-05,8,14721,33,692,725,False
2012-09-05,9,14722,27,263,290,False
2012-09-05,10,14723,54,181,235,False
2012-09-05,11,14724,61,156,217,False
2012-09-05,12,14725,49,217,266,False
2012-09-05,13,14726,50,184,234,False
2012-09-05,14,14727,34,177,211,False
2012-09-05,15,14728,41,204,245,False
2012-09-05,16,14729,86,344,430,False
2012-09-05,17,14730,83,780,863,False
2012-09-05,18,14731,82,757,839,False
2012-09-05,19,14732,64,598,662,False
2012-09-05,20,14733,55,357,412,False
2012-09-05,21,14734,18,278,296,False
2012-09-05,22,14735,38,181,219,False
2012-09-05,23,14736,24,126,150,False
2012-09-06,0,14737,30,35,65,False
2012-09-06,1,14738,2,16,18,False
2012-09-06,2,14739,1,7,8,False
2012-09-06,3,14740,0,9,9,False
2012-09-06,4,14741,0,8,8,False
2012-09-06,5,14742,3,35,38,False
2012-09-06,6,14743,11,189,200,False
2012-09-06,7,14744,21,461,482,False
2012-09-06,8,14745,24,622,646,False
2012-09-06,9,14746,8,115,123,False
2012-09-06,10,14747,9,40,49,False
2012-09-06,11,14748,10,52,62,False
2012-09-06,12,14749,11,126,137,False
2012-09-06,13,14750,39,152,191,False
2012-09-06,14,14751,38,178,216,False
2012-09-06,15,14752,42,228,270,False
2012-09-06,16,14753,42,374,416,False
2012-09-06,17,14754,67,741,808,False
2012-09-06,18,14755,74,761,835,False
2012-09-06,19,14756,54,504,558,False
2012-09-06,20,14757,50,356,406,False
2012-09-06,21,14758,32,240,272,False
2012-09-06,22,14759,24,193,217,False
2012-09-06,23,14760,19,150,169,False
2012-09-07,0,14761,17,79,96,False
2012-09-07,1,14762,10,19,29,False
2012-09-07,2,14763,1,10,11,False
2012-09-07,3,14764,0,9,9,False
2012-09-07,4,14765,1,7,8,False
2012-09-07,5,14766,1,39,40,False
2012-09-07,6,14767,5,135,140,False
2012-09-07,7,14768,21,465,486,False
2012-09-07,8,14769,29,690,719,False
2012-09-07,9,14770,33,311,344,False
2012-09-07,10,14771,53,171,224,False
2012-09-07,11,14772,81,215,296,False
2012-09-07,12,14773,76,247,323,False
2012-09-07,13,14774,71,283,354,False
2012-09-07,14,14775,66,187,253,False
2012-09-07,15,14776,66,265,331,False
2012-09-07,16,14777,75,395,470,False
2012-09-07,17,14778,88,684,772,False
2012-09-07,18,14779,95,697,792,False
2012-09-07,19,14780,70,498,568,False
2012-09-07,20,14781,51,340,391,False
2012-09-07,21,14782,55,246,301,False
2012-09-07,22,14783,52,247,299,False
2012-09-07,23,14784,28,220,248,False
2012-09-08,0,14785,20,130,150,False
2012-09-08,1,14786,10,107,117,False
2012-09-08,2,14787,9,68,77,False
2012-09-08,3,14788,3,40,43,False
2012-09-08,4,14789,3,8,11,False
2012-09-08,5,14790,2,13,15,False
2012-09-08,6,14791,8,26,34,False
2012-09-08,7,14792,11,71,82,False
2012-09-08,8,14793,33,197,230,False
2012-09-08,9,14794,87,261,348,False
2012-09-08,10,14795,100,322,422,False
2012-09-08,11,14796,173,405,578,False
2012-09-08,12,14797,220,474,694,False
2012-09-08,13,14798,233,435,668,False
2012-09-08,14,14799,260,366,626,False
2012-09-08,15,14800,175,337,512,False
2012-09-08,16,14801,19,95,114,False
2012-09-08,17,14802,52,119,171,False
2012-09-08,18,14803,27,140,167,False
2012-09-08,19,14804,28,187,215,False
2012-09-08,20,14805,28,166,194,False
2012-09-08,21,14806,26,155,181,False
2012-09-08,22,14807,18,176,194,False
2012-09-08,23,14808,12,121,133,False
2012-09-09,0,14809,18,106,124,False
2012-09-09,1,14810,20,104,124,False
2012-09-09,2,14811,15,81,96,False
2012-09-09,3,14812,14,32,46,False
2012-09-09,4,14813,12,16,28,False
2012-09-09,5,14814,16,39,55,False
2012-09-09,6,14815,11,24,35,False
2012-09-09,7,14816,20,50,70,False
2012-09-09,8,14817,27,143,170,False
2012-09-09,9,14818,85,214,299,False
2012-09-09,10,14819,172,323,495,False
2012-09-09,11,14820,194,391,585,False
2012-09-09,12,14821,247,510,757,False
2012-09-09,13,14822,238,491,729,False
2012-09-09,14,14823,232,415,647,False
2012-09-09,15,14824,284,412,696,False
2012-09-09,16,14825,228,473,701,False
2012-09-09,17,14826,213,458,671,False
2012-09-09,18,14827,156,404,560,False
2012-09-09,19,14828,134,362,496,False
2012-09-09,20,14829,91,265,356,False
2012-09-09,21,14830,57,149,206,False
2012-09-09,22,14831,64,125,189,False
2012-09-09,23,14832,22,70,92,False
2012-09-10,0,14833,6,35,41,False
2012-09-10,1,14834,7,11,18,False
2012-09-10,2,14835,11,6,17,False
2012-09-10,3,14836,5,7,12,False
2012-09-10,4,14837,1,4,5,False
2012-09-10,5,14838,4,36,40,False
2012-09-10,6,14839,8,172,180,False
2012-09-10,7,14840,20,427,447,False
2012-09-10,8,14841,33,697,730,False
2012-09-10,9,14842,40,321,361,False
2012-09-10,10,14843,42,168,210,False
2012-09-10,11,14844,69,167,236,False
2012-09-10,12,14845,76,256,332,False
2012-09-10,13,14846,72,251,323,False
2012-09-10,14,14847,107,233,340,False
2012-09-10,15,14848,115,231,346,False
2012-09-10,16,14849,108,380,488,False
2012-09-10,17,14850,127,744,871,False
2012-09-10,18,14851,111,857,968,False
2012-09-10,19,14852,71,562,633,False
2012-09-10,20,14853,34,356,390,False
2012-09-10,21,14854,29,256,285,False
2012-09-10,22,14855,15,144,159,False
2012-09-10,23,14856,7,86,93,False
2012-09-11,0,14857,5,27,32,False
2012-09-11,1,14858,0,10,10,False
2012-09-11,2,14859,1,5,6,False
2012-09-11,3,14860,1,7,8,False
2012-09-11,4,14861,1,8,9,False
2012-09-11,5,14862,3,41,44,False
2012-09-11,6,14863,11,200,211,False
2012-09-11,7,14864,24,572,596,False
2012-09-11,8,14865,48,702,750,False
2012-09-11,9,14866,35,323,358,False
2012-09-11,10,14867,54,142,196,False
2012-09-11,11,14868,60,187,247,False
2012-09-11,12,14869,62,254,316,False
2012-09-11,13,14870,72,256,328,False
2012-09-11,14,14871,74,181,255,False
2012-09-11,15,14872,73,253,326,False
2012-09-11,16,14873,99,437,536,False
2012-09-11,17,14874,168,802,970,False
2012-09-11,18,14875,110,767,877,False
2012-09-11,19,14876,56,540,596,False
2012-09-11,20,14877,40,421,461,False
2012-09-11,21,14878,28,282,310,False
2012-09-11,22,14879,27,189,216,False
2012-09-11,23,14880,18,91,109,False
2012-09-12,0,14881,8,41,49,False
2012-09-12,1,14882,2,19,21,False
2012-09-12,2,14883,2,9,11,False
2012-09-12,3,14884,0,7,7,False
2012-09-12,4,14885,0,5,5,False
2012-09-12,5,14886,4,44,48,False
2012-09-12,6,14887,6,199,205,False
2012-09-12,7,14888,24,533,557,False
2012-09-12,8,14889,43,727,770,False
2012-09-12,9,14890,50,278,328,False
2012-09-12,10,14891,57,148,205,False
2012-09-12,11,14892,51,181,232,False
2012-09-12,12,14893,88,264,352,False
2012-09-12,13,14894,85,238,323,False
2012-09-12,14,14895,78,200,278,False
2012-09-12,15,14896,75,243,318,False
2012-09-12,16,14897,90,419,509,False
2012-09-12,17,14898,114,811,925,False
2012-09-12,18,14899,91,886,977,False
2012-09-12,19,14900,78,557,635,False
2012-09-12,20,14901,38,432,470,False
2012-09-12,21,14902,27,279,306,False
2012-09-12,22,14903,23,189,212,False
2012-09-12,23,14904,16,111,127,False
2012-09-13,0,14905,11,46,57,False
2012-09-13,1,14906,6,22,28,False
2012-09-13,2,14907,0,9,9,False
2012-09-13,3,14908,2,9,11,False
2012-09-13,4,14909,0,6,6,False
2012-09-13,5,14910,3,54,57,False
2012-09-13,6,14911,9,186,195,False
2012-09-13,7,14912,22,549,571,False
2012-09-13,8,14913,33,725,758,False
2012-09-13,9,14914,46,292,338,False
2012-09-13,10,14915,63,149,212,False
2012-09-13,11,14916,71,183,254,False
2012-09-13,12,14917,57,240,297,False
2012-09-13,13,14918,60,223,283,False
2012-09-13,14,14919,60,214,274,False
2012-09-13,15,14920,99,253,352,False
2012-09-13,16,14921,85,406,491,False
2012-09-13,17,14922,97,787,884,False
2012-09-13,18,14923,108,744,852,False
2012-09-13,19,14924,80,594,674,False
2012-09-13,20,14925,55,408,463,False
2012-09-13,21,14926,26,291,317,False
2012-09-13,22,14927,28,223,251,False
2012-09-13,23,14928,33,137,170,False
2012-09-14,0,14929,24,63,87,False
2012-09-14,1,14930,6,35,41,False
2012-09-14,2,14931,7,23,30,False
2012-09-14,3,14932,5,9,14,False
2012-09-14,4,14933,1,11,12,False
2012-09-14,5,14934,1,40,41,False
2012-09-14,6,14935,8,144,152,False
2012-09-14,7,14936,17,437,454,False
2012-09-14,8,14937,51,715,766,False
2012-09-14,9,14938,46,301,347,False
2012-09-14,10,14939,75,171,246,False
2012-09-14,11,14940,84,196,280,False
2012-09-14,12,14941,119,290,409,False
2012-09-14,13,14942,107,301,408,False
2012-09-14,14,14943,113,258,371,False
2012-09-14,15,14944,94,273,367,False
2012-09-14,16,14945,109,454,563,False
2012-09-14,17,14946,137,757,894,False
2012-09-14,18,14947,116,692,808,False
2012-09-14,19,14948,83,496,579,False
2012-09-14,20,14949,67,337,404,False
2012-09-14,21,14950,42,270,312,False
2012-09-14,22,14951,40,189,229,False
2012-09-14,23,14952,27,168,195,False
2012-09-15,0,14953,38,169,207,False
2012-09-15,1,14954,8,101,109,False
2012-09-15,2,14955,18,75,93,False
2012-09-15,3,14956,6,31,37,False
2012-09-15,4,14957,3,3,6,False
2012-09-15,5,14958,1,15,16,False
2012-09-15,6,14959,6,27,33,False
2012-09-15,7,14960,10,63,73,False
2012-09-15,8,14961,43,169,212,False
2012-09-15,9,14962,79,263,342,False
2012-09-15,10,14963,119,323,442,False
2012-09-15,11,14964,228,399,627,False
2012-09-15,12,14965,287,419,706,False
2012-09-15,13,14966,327,377,704,False
2012-09-15,14,14967,325,390,715,False
2012-09-15,15,14968,312,342,654,False
2012-09-15,16,14969,350,433,783,False
2012-09-15,17,14970,295,434,729,False
2012-09-15,18,14971,232,382,614,False
2012-09-15,19,14972,169,309,478,False
2012-09-15,20,14973,89,241,330,False
2012-09-15,21,14974,86,210,296,False
2012-09-15,22,14975,82,197,279,False
2012-09-15,23,14976,47,182,229,False
2012-09-16,0,14977,28,123,151,False
2012-09-16,1,14978,35,82,117,False
2012-09-16,2,14979,27,62,89,False
2012-09-16,3,14980,10,38,48,False
2012-09-16,4,14981,2,6,8,False
2012-09-16,5,14982,3,10,13,False
2012-09-16,6,14983,9,26,35,False
2012-09-16,7,14984,28,43,71,False
2012-09-16,8,14985,34,94,128,False
2012-09-16,9,14986,70,226,296,False
2012-09-16,10,14987,160,330,490,False
2012-09-16,11,14988,183,376,559,False
2012-09-16,12,14989,188,468,656,False
2012-09-16,13,14990,240,454,694,False
2012-09-16,14,14991,225,410,635,False
2012-09-16,15,14992,215,342,557,False
2012-09-16,16,14993,194,402,596,False
2012-09-16,17,14994,177,393,570,False
2012-09-16,18,14995,120,361,481,False
2012-09-16,19,14996,91,312,403,False
2012-09-16,20,14997,57,267,324,False
2012-09-16,21,14998,43,148,191,False
2012-09-16,22,14999,18,109,127,False
2012-09-16,23,15000,9,85,94,False
2012-09-17,0,15001,14,31,45,False
2012-09-17,1,15002,9,12,21,False
2012-09-17,2,15003,5,8,13,False
2012-09-17,3,15004,0,7,7,False
2012-09-17,4,15005,2,9,11,False
2012-09-17,5,15006,1,44,45,False
2012-09-17,6,15007,7,157,164,False
2012-09-17,7,15008,18,474,492,False
2012-09-17,8,15009,36,647,683,False
2012-09-17,9,15010,34,265,299,False
2012-09-17,10,15011,73,129,202,False
2012-09-17,11,15012,61,191,252,False
2012-09-17,12,15013,62,233,295,False
2012-09-17,13,15014,112,231,343,False
2012-09-17,14,15015,129,203,332,False
2012-09-17,15,15016,82,256,338,False
2012-09-17,16,15017,74,379,453,False
2012-09-17,17,15018,102,740,842,False
2012-09-17,18,15019,66,708,774,False
2012-09-17,19,15020,51,435,486,False
2012-09-17,20,15021,32,308,340,False
2012-09-17,21,15022,28,205,233,False
2012-09-17,22,15023,20,109,129,False
2012-09-17,23,15024,4,66,70,False
2012-09-18,0,15025,2,11,13,False
2012-09-18,1,15026,0,5,5,False
2012-09-18,2,15027,0,4,4,False
2012-09-18,3,15028,0,6,6,False
2012-09-18,4,15029,2,5,7,False
2012-09-18,5,15030,3,45,48,False
2012-09-18,6,15031,4,163,167,False
2012-09-18,7,15032,13,343,356,False
2012-09-18,8,15033,32,640,672,False
2012-09-18,9,15034,27,266,293,False
2012-09-18,10,15035,30,130,160,False
2012-09-18,11,15036,36,115,151,False
2012-09-18,12,15037,16,72,88,False
2012-09-18,13,15038,17,97,114,False
2012-09-18,14,15039,27,116,143,False
2012-09-18,15,15040,1,35,36,False
2012-09-18,16,15041,19,122,141,False
2012-09-18,17,15042,36,302,338,False
2012-09-18,18,15043,19,262,281,False
2012-09-18,19,15044,22,302,324,False
2012-09-18,20,15045,19,271,290,False
2012-09-18,21,15046,21,186,207,False
2012-09-18,22,15047,14,137,151,False
2012-09-18,23,15048,11,67,78,False
2012-09-19,0,15049,3,23,26,False
2012-09-19,1,15050,0,12,12,False
2012-09-19,2,15051,0,3,3,False
2012-09-19,3,15052,1,4,5,False
2012-09-19,4,15053,0,10,10,False
2012-09-19,5,15054,2,54,56,False
2012-09-19,6,15055,6,166,172,False
2012-09-19,7,15056,16,529,545,False
2012-09-19,8,15057,39,758,797,False
2012-09-19,9,15058,26,336,362,False
2012-09-19,10,15059,23,169,192,False
2012-09-19,11,15060,44,203,247,False
2012-09-19,12,15061,53,260,313,False
2012-09-19,13,15062,55,234,289,False
2012-09-19,14,15063,59,227,286,False
2012-09-19,15,15064,57,254,311,False
2012-09-19,16,15065,69,397,466,False
2012-09-19,17,15066,74,812,886,False
2012-09-19,18,15067,85,807,892,False
2012-09-19,19,15068,72,539,611,False
2012-09-19,20,15069,31,378,409,False
2012-09-19,21,15070,25,324,349,False
2012-09-19,22,15071,31,198,229,False
2012-09-19,23,15072,17,106,123,False
2012-09-20,0,15073,12,46,58,False
2012-09-20,1,15074,4,14,18,False
2012-09-20,2,15075,2,9,11,False
2012-09-20,3,15076,0,6,6,False
2012-09-20,4,15077,0,6,6,False
2012-09-20,5,15078,4,52,56,False
2012-09-20,6,15079,9,161,170,False
2012-09-20,7,15080,20,514,534,False
2012-09-20,8,15081,44,746,790,False
2012-09-20,9,15082,25,330,355,False
2012-09-20,10,15083,33,157,190,False
2012-09-20,11,15084,37,206,243,False
2012-09-20,12,15085,57,233,290,False
2012-09-20,13,15086,68,268,336,False
2012-09-20,14,15087,76,222,298,False
2012-09-20,15,15088,60,231,291,False
2012-09-20,16,15089,72,385,457,False
2012-09-20,17,15090,91,885,976,False
2012-09-20,18,15091,119,781,900,False
2012-09-20,19,15092,69,534,603,False
2012-09-20,20,15093,57,360,417,False
2012-09-20,21,15094,28,246,274,False
2012-09-20,22,15095,35,252,287,False
2012-09-20,23,15096,17,137,154,False
2012-09-21,0,15097,13,53,66,False
2012-09-21,1,15098,11,38,49,False
2012-09-21,2,15099,6,8,14,False
2012-09-21,3,15100,1,11,12,False
2012-09-21,4,15101,1,9,10,False
2012-09-21,5,15102,2,47,49,False
2012-09-21,6,15103,19,146,165,False
2012-09-21,7,15104,35,468,503,False
2012-09-21,8,15105,31,726,757,False
2012-09-21,9,15106,35,348,383,False
2012-09-21,10,15107,44,181,225,False
2012-09-21,11,15108,79,242,321,False
2012-09-21,12,15109,84,305,389,False
2012-09-21,13,15110,105,316,421,False
2012-09-21,14,15111,113,299,412,False
2012-09-21,15,15112,90,333,423,False
2012-09-21,16,15113,103,464,567,False
2012-09-21,17,15114,107,739,846,False
2012-09-21,18,15115,106,699,805,False
2012-09-21,19,15116,95,493,588,False
2012-09-21,20,15117,54,315,369,False
2012-09-21,21,15118,46,266,312,False
2012-09-21,22,15119,47,248,295,False
2012-09-21,23,15120,23,163,186,False
2012-09-22,0,15121,32,140,172,False
2012-09-22,1,15122,18,106,124,False
2012-09-22,2,15123,10,73,83,False
2012-09-22,3,15124,6,39,45,False
2012-09-22,4,15125,5,10,15,False
2012-09-22,5,15126,2,15,17,False
2012-09-22,6,15127,6,35,41,False
2012-09-22,7,15128,7,70,77,False
2012-09-22,8,15129,21,197,218,False
2012-09-22,9,15130,88,289,377,False
2012-09-22,10,15131,124,350,474,False
2012-09-22,11,15132,189,437,626,False
2012-09-22,12,15133,228,460,688,False
2012-09-22,13,15134,273,434,707,False
2012-09-22,14,15135,250,404,654,False
2012-09-22,15,15136,307,443,750,False
2012-09-22,16,15137,253,427,680,False
2012-09-22,17,15138,195,451,646,False
2012-09-22,18,15139,171,427,598,False
2012-09-22,19,15140,99,308,407,False
2012-09-22,20,15141,76,249,325,False
2012-09-22,21,15142,59,202,261,False
2012-09-22,22,15143,59,180,239,False
2012-09-22,23,15144,34,137,171,False
2012-09-23,0,15145,34,146,180,False
2012-09-23,1,15146,23,119,142,False
2012-09-23,2,15147,18,77,95,False
2012-09-23,3,15148,13,41,54,False
2012-09-23,4,15149,1,9,10,False
2012-09-23,5,15150,1,5,6,False
2012-09-23,6,15151,5,11,16,False
2012-09-23,7,15152,9,48,57,False
2012-09-23,8,15153,38,137,175,False
2012-09-23,9,15154,71,205,276,False
2012-09-23,10,15155,138,351,489,False
2012-09-23,11,15156,186,384,570,False
2012-09-23,12,15157,250,526,776,False
2012-09-23,13,15158,257,445,702,False
2012-09-23,14,15159,266,400,666,False
2012-09-23,15,15160,265,375,640,False
2012-09-23,16,15161,254,437,691,False
2012-09-23,17,15162,227,496,723,False
2012-09-23,18,15163,135,405,540,False
2012-09-23,19,15164,82,331,413,False
2012-09-23,20,15165,60,192,252,False
2012-09-23,21,15166,51,145,196,False
2012-09-23,22,15167,40,98,138,False
2012-09-23,23,15168,30,70,100,False
2012-09-24,0,15169,10,54,64,False
2012-09-24,1,15170,6,12,18,False
2012-09-24,2,15171,0,8,8,False
2012-09-24,3,15172,0,5,5,False
2012-09-24,4,15173,0,8,8,False
2012-09-24,5,15174,2,35,37,False
2012-09-24,6,15175,6,162,168,False
2012-09-24,7,15176,17,513,530,False
2012-09-24,8,15177,31,719,750,False
2012-09-24,9,15178,42,286,328,False
2012-09-24,10,15179,52,146,198,False
2012-09-24,11,15180,71,167,238,False
2012-09-24,12,15181,77,265,342,False
2012-09-24,13,15182,80,248,328,False
2012-09-24,14,15183,77,226,303,False
2012-09-24,15,15184,84,216,300,False
2012-09-24,16,15185,99,417,516,False
2012-09-24,17,15186,89,809,898,False
2012-09-24,18,15187,95,758,853,False
2012-09-24,19,15188,56,534,590,False
2012-09-24,20,15189,52,380,432,False
2012-09-24,21,15190,26,230,256,False
2012-09-24,22,15191,18,154,172,False
2012-09-24,23,15192,11,83,94,False
2012-09-25,0,15193,8,56,64,False
2012-09-25,1,15194,2,11,13,False
2012-09-25,2,15195,5,9,14,False
2012-09-25,3,15196,2,3,5,False
2012-09-25,4,15197,2,7,9,False
2012-09-25,5,15198,1,46,47,False
2012-09-25,6,15199,5,189,194,False
2012-09-25,7,15200,17,539,556,False
2012-09-25,8,15201,41,764,805,False
2012-09-25,9,15202,28,381,409,False
2012-09-25,10,15203,45,125,170,False
2012-09-25,11,15204,63,155,218,False
2012-09-25,12,15205,69,233,302,False
2012-09-25,13,15206,48,257,305,False
2012-09-25,14,15207,80,213,293,False
2012-09-25,15,15208,56,247,303,False
2012-09-25,16,15209,59,436,495,False
2012-09-25,17,15210,107,860,967,False
2012-09-25,18,15211,64,758,822,False
2012-09-25,19,15212,49,490,539,False
2012-09-25,20,15213,37,388,425,False
2012-09-25,21,15214,34,263,297,False
2012-09-25,22,15215,14,174,188,False
2012-09-25,23,15216,9,89,98,False
2012-09-26,0,15217,6,34,40,False
2012-09-26,1,15218,10,19,29,False
2012-09-26,2,15219,2,15,17,False
2012-09-26,3,15220,4,6,10,False
2012-09-26,4,15221,2,12,14,False
2012-09-26,5,15222,1,35,36,False
2012-09-26,6,15223,3,179,182,False
2012-09-26,7,15224,9,523,532,False
2012-09-26,8,15225,30,808,838,False
2012-09-26,9,15226,27,307,334,False
2012-09-26,10,15227,29,156,185,False
2012-09-26,11,15228,46,181,227,False
2012-09-26,12,15229,56,260,316,False
2012-09-26,13,15230,67,273,340,False
2012-09-26,14,15231,60,217,277,False
2012-09-26,15,15232,69,231,300,False
2012-09-26,16,15233,71,397,468,False
2012-09-26,17,15234,77,876,953,False
2012-09-26,18,15235,69,815,884,False
2012-09-26,19,15236,38,589,627,False
2012-09-26,20,15237,45,389,434,False
2012-09-26,21,15238,32,328,360,False
2012-09-26,22,15239,21,194,215,False
2012-09-26,23,15240,13,102,115,False
2012-09-27,0,15241,5,60,65,False
2012-09-27,1,15242,5,16,21,False
2012-09-27,2,15243,3,13,16,False
2012-09-27,3,15244,0,7,7,False
2012-09-27,4,15245,2,6,8,False
2012-09-27,5,15246,2,64,66,False
2012-09-27,6,15247,5,164,169,False
2012-09-27,7,15248,12,546,558,False
2012-09-27,8,15249,20,774,794,False
2012-09-27,9,15250,30,305,335,False
2012-09-27,10,15251,40,168,208,False
2012-09-27,11,15252,67,227,294,False
2012-09-27,12,15253,63,272,335,False
2012-09-27,13,15254,61,265,326,False
2012-09-27,14,15255,44,214,258,False
2012-09-27,15,15256,41,255,296,False
2012-09-27,16,15257,73,399,472,False
2012-09-27,17,15258,87,818,905,False
2012-09-27,18,15259,77,822,899,False
2012-09-27,19,15260,48,511,559,False
2012-09-27,20,15261,45,412,457,False
2012-09-27,21,15262,18,235,253,False
2012-09-27,22,15263,2,45,47,False
2012-09-27,23,15264,1,44,45,False
2012-09-28,0,15265,2,15,17,False
2012-09-28,1,15266,0,13,13,False
2012-09-28,2,15267,1,9,10,False
2012-09-28,3,15268,0,7,7,False
2012-09-28,4,15269,2,10,12,False
2012-09-28,5,15270,1,37,38,False
2012-09-28,6,15271,2,136,138,False
2012-09-28,7,15272,10,384,394,False
2012-09-28,8,15273,31,674,705,False
2012-09-28,9,15274,27,399,426,False
2012-09-28,10,15275,51,194,245,False
2012-09-28,11,15276,109,252,361,False
2012-09-28,12,15277,94,286,380,False
2012-09-28,13,15278,106,304,410,False
2012-09-28,14,15279,105,294,399,False
2012-09-28,15,15280,104,288,392,False
2012-09-28,16,15281,83,419,502,False
2012-09-28,17,15282,101,707,808,False
2012-09-28,18,15283,58,609,667,False
2012-09-28,19,15284,38,470,508,False
2012-09-28,20,15285,32,304,336,False
2012-09-28,21,15286,32,205,237,False
2012-09-28,22,15287,30,190,220,False
2012-09-28,23,15288,26,164,190,False
2012-09-29,0,15289,15,134,149,False
2012-09-29,1,15290,12,89,101,False
2012-09-29,2,15291,12,80,92,False
2012-09-29,3,15292,4,25,29,False
2012-09-29,4,15293,6,8,14,False
2012-09-29,5,15294,2,13,15,False
2012-09-29,6,15295,4,33,37,False
2012-09-29,7,15296,12,61,73,False
2012-09-29,8,15297,37,174,211,False
2012-09-29,9,15298,69,263,332,False
2012-09-29,10,15299,134,338,472,False
2012-09-29,11,15300,217,446,663,False
2012-09-29,12,15301,191,491,682,False
2012-09-29,13,15302,233,453,686,False
2012-09-29,14,15303,302,448,750,False
2012-09-29,15,15304,271,456,727,False
2012-09-29,16,15305,275,447,722,False
2012-09-29,17,15306,256,456,712,False
2012-09-29,18,15307,174,420,594,False
2012-09-29,19,15308,119,351,470,False
2012-09-29,20,15309,88,227,315,False
2012-09-29,21,15310,73,219,292,False
2012-09-29,22,15311,48,173,221,False
2012-09-29,23,15312,35,161,196,False
2012-09-30,0,15313,35,112,147,False
2012-09-30,1,15314,31,85,116,False
2012-09-30,2,15315,21,71,92,False
2012-09-30,3,15316,17,41,58,False
2012-09-30,4,15317,1,6,7,False
2012-09-30,5,15318,1,9,10,False
2012-09-30,6,15319,2,20,22,False
2012-09-30,7,15320,14,43,57,False
2012-09-30,8,15321,18,126,144,False
2012-09-30,9,15322,74,211,285,False
2012-09-30,10,15323,160,319,479,False
2012-09-30,11,15324,222,369,591,False
2012-09-30,12,15325,206,474,680,False
2012-09-30,13,15326,180,414,594,False
2012-09-30,14,15327,208,404,612,False
2012-09-30,15,15328,230,419,649,False
2012-09-30,16,15329,202,446,648,False
2012-09-30,17,15330,195,380,575,False
2012-09-30,18,15331,91,310,401,False
2012-09-30,19,15332,34,223,257,False
2012-09-30,20,15333,31,163,194,False
2012-09-30,21,15334,19,104,123,False
2012-09-30,22,15335,15,76,91,False
2012-09-30,23,15336,8,49,57,False
2012-10-01,0,15337,6,39,45,False
2012-10-01,1,15338,5,13,18,False
2012-10-01,2,15339,6,6,12,False
2012-10-01,3,15340,1,6,7,False
2012-10-01,4,15341,0,10,10,False
2012-10-01,5,15342,2,34,36,False
2012-10-01,6,15343,8,147,155,False
2012-10-01,7,15344,13,470,483,False
2012-10-01,8,15345,40,744,784,False
2012-10-01,9,15346,26,314,340,False
2012-10-01,10,15347,44,135,179,False
2012-10-01,11,15348,76,196,272,False
2012-10-01,12,15349,61,262,323,False
2012-10-01,13,15350,80,225,305,False
2012-10-01,14,15351,51,193,244,False
2012-10-01,15,15352,95,234,329,False
2012-10-01,16,15353,51,408,459,False
2012-10-01,17,15354,65,791,856,False
2012-10-01,18,15355,42,571,613,False
2012-10-01,19,15356,33,483,516,False
2012-10-01,20,15357,11,251,262,False
2012-10-01,21,15358,13,205,218,False
2012-10-01,22,15359,17,190,207,False
2012-10-01,23,15360,17,88,105,False
2012-10-02,0,15361,1,30,31,False
2012-10-02,1,15362,0,11,11,False
2012-10-02,2,15363,0,2,2,False
2012-10-02,3,15364,1,4,5,False
2012-10-02,4,15365,2,8,10,False
2012-10-02,5,15366,1,42,43,False
2012-10-02,6,15367,3,176,179,False
2012-10-02,7,15368,4,256,260,False
2012-10-02,8,15369,6,128,134,False
2012-10-02,9,15370,3,83,86,False
2012-10-02,10,15371,3,42,45,False
2012-10-02,11,15372,7,92,99,False
2012-10-02,12,15373,6,98,104,False
2012-10-02,13,15374,6,148,154,False
2012-10-02,14,15375,16,147,163,False
2012-10-02,15,15376,14,195,209,False
2012-10-02,16,15377,46,328,374,False
2012-10-02,17,15378,38,677,715,False
2012-10-02,18,15379,48,639,687,False
2012-10-02,19,15380,27,368,395,False
2012-10-02,20,15381,20,286,306,False
2012-10-02,21,15382,24,265,289,False
2012-10-02,22,15383,28,212,240,False
2012-10-02,23,15384,11,87,98,False
2012-10-03,0,15385,5,47,52,False
2012-10-03,1,15386,3,16,19,False
2012-10-03,2,15387,2,7,9,False
2012-10-03,3,15388,0,7,7,False
2012-10-03,4,15389,2,9,11,False
2012-10-03,5,15390,2,32,34,False
2012-10-03,6,15391,4,173,177,False
2012-10-03,7,15392,11,504,515,False
2012-10-03,8,15393,28,781,809,False
2012-10-03,9,15394,30,332,362,False
2012-10-03,10,15395,29,146,175,False
2012-10-03,11,15396,52,178,230,False
2012-10-03,12,15397,69,289,358,False
2012-10-03,13,15398,55,224,279,False
2012-10-03,14,15399,56,195,251,False
2012-10-03,15,15400,59,260,319,False
2012-10-03,16,15401,42,436,478,False
2012-10-03,17,15402,84,833,917,False
2012-10-03,18,15403,54,756,810,False
2012-10-03,19,15404,49,544,593,False
2012-10-03,20,15405,48,449,497,False
2012-10-03,21,15406,14,195,209,False
2012-10-03,22,15407,9,232,241,False
2012-10-03,23,15408,21,199,220,False
2012-10-04,0,15409,11,65,76,False
2012-10-04,1,15410,2,23,25,False
2012-10-04,2,15411,3,10,13,False
2012-10-04,3,15412,5,6,11,False
2012-10-04,4,15413,0,10,10,False
2012-10-04,5,15414,2,37,39,False
2012-10-04,6,15415,1,132,133,False
2012-10-04,7,15416,12,379,391,False
2012-10-04,8,15417,27,711,738,False
2012-10-04,9,15418,40,319,359,False
2012-10-04,10,15419,27,150,177,False
2012-10-04,11,15420,38,176,214,False
2012-10-04,12,15421,57,231,288,False
2012-10-04,13,15422,63,231,294,False
2012-10-04,14,15423,56,211,267,False
2012-10-04,15,15424,77,248,325,False
2012-10-04,16,15425,86,411,497,False
2012-10-04,17,15426,112,789,901,False
2012-10-04,18,15427,75,812,887,False
2012-10-04,19,15428,67,467,534,False
2012-10-04,20,15429,50,391,441,False
2012-10-04,21,15430,33,288,321,False
2012-10-04,22,15431,29,203,232,False
2012-10-04,23,15432,18,137,155,False
2012-10-05,0,15433,16,86,102,False
2012-10-05,1,15434,3,43,46,False
2012-10-05,2,15435,1,10,11,False
2012-10-05,3,15436,5,11,16,False
2012-10-05,4,15437,0,11,11,False
2012-10-05,5,15438,0,41,41,False
2012-10-05,6,15439,4,133,137,False
2012-10-05,7,15440,11,417,428,False
2012-10-05,8,15441,36,749,785,False
2012-10-05,9,15442,58,326,384,False
2012-10-05,10,15443,68,192,260,False
2012-10-05,11,15444,90,214,304,False
2012-10-05,12,15445,161,307,468,False
2012-10-05,13,15446,117,307,424,False
2012-10-05,14,15447,113,287,400,False
2012-10-05,15,15448,150,320,470,False
2012-10-05,16,15449,153,481,634,False
2012-10-05,17,15450,158,742,900,False
2012-10-05,18,15451,106,655,761,False
2012-10-05,19,15452,67,433,500,False
2012-10-05,20,15453,66,306,372,False
2012-10-05,21,15454,47,220,267,False
2012-10-05,22,15455,63,201,264,False
2012-10-05,23,15456,23,148,171,False
2012-10-06,0,15457,37,154,191,False
2012-10-06,1,15458,25,116,141,False
2012-10-06,2,15459,13,62,75,False
2012-10-06,3,15460,2,54,56,False
2012-10-06,4,15461,4,7,11,False
2012-10-06,5,15462,2,8,10,False
2012-10-06,6,15463,2,28,30,False
2012-10-06,7,15464,13,71,84,False
2012-10-06,8,15465,22,184,206,False
2012-10-06,9,15466,130,265,395,False
2012-10-06,10,15467,198,341,539,False
2012-10-06,11,15468,258,389,647,False
2012-10-06,12,15469,362,381,743,False
2012-10-06,13,15470,310,400,710,False
2012-10-06,14,15471,269,307,576,False
2012-10-06,15,15472,279,341,620,False
2012-10-06,16,15473,317,342,659,False
2012-10-06,17,15474,268,342,610,False
2012-10-06,18,15475,183,312,495,False
2012-10-06,19,15476,102,239,341,False
2012-10-06,20,15477,75,172,247,False
2012-10-06,21,15478,78,137,215,False
2012-10-06,22,15479,45,140,185,False
2012-10-06,23,15480,37,142,179,False
2012-10-07,0,15481,28,99,127,False
2012-10-07,1,15482,29,80,109,False
2012-10-07,2,15483,10,64,74,False
2012-10-07,3,15484,5,17,22,False
2012-10-07,4,15485,5,6,11,False
2012-10-07,5,15486,2,8,10,False
2012-10-07,6,15487,4,19,23,False
2012-10-07,7,15488,6,29,35,False
2012-10-07,8,15489,11,51,62,False
2012-10-07,9,15490,16,70,86,False
2012-10-07,10,15491,41,144,185,False
2012-10-07,11,15492,76,260,336,False
2012-10-07,12,15493,100,292,392,False
2012-10-07,13,15494,80,240,320,False
2012-10-07,14,15495,71,243,314,False
2012-10-07,15,15496,74,232,306,False
2012-10-07,16,15497,87,246,333,False
2012-10-07,17,15498,35,122,157,False
2012-10-07,18,15499,24,82,106,False
2012-10-07,19,15500,17,97,114,False
2012-10-07,20,15501,19,97,116,False
2012-10-07,21,15502,22,91,113,False
2012-10-07,22,15503,7,72,79,False
2012-10-07,23,15504,12,68,80,False
2012-10-08,0,15505,7,44,51,False
2012-10-08,1,15506,2,35,37,False
2012-10-08,2,15507,3,12,15,False
2012-10-08,3,15508,2,8,10,False
2012-10-08,4,15509,1,6,7,False
2012-10-08,5,15510,2,17,19,False
2012-10-08,6,15511,5,54,59,False
2012-10-08,7,15512,3,151,154,False
2012-10-08,8,15513,23,374,397,False
2012-10-08,9,15514,59,273,332,False
2012-10-08,10,15515,69,229,298,False
2012-10-08,11,15516,72,236,308,False
2012-10-08,12,15517,74,267,341,False
2012-10-08,13,15518,82,323,405,False
2012-10-08,14,15519,121,299,420,False
2012-10-08,15,15520,76,294,370,False
2012-10-08,16,15521,61,316,377,False
2012-10-08,17,15522,81,416,497,False
2012-10-08,18,15523,41,415,456,False
2012-10-08,19,15524,38,333,371,False
2012-10-08,20,15525,20,207,227,False
2012-10-08,21,15526,17,134,151,False
2012-10-08,22,15527,6,101,107,False
2012-10-08,23,15528,9,60,69,False
2012-10-09,0,15529,9,22,31,False
2012-10-09,1,15530,0,13,13,False
2012-10-09,2,15531,2,5,7,False
2012-10-09,3,15532,0,3,3,False
2012-10-09,4,15533,1,6,7,False
2012-10-09,5,15534,0,19,19,False
2012-10-09,6,15535,2,141,143,False
2012-10-09,7,15536,5,357,362,False
2012-10-09,8,15537,15,698,713,False
2012-10-09,9,15538,37,345,382,False
2012-10-09,10,15539,33,131,164,False
2012-10-09,11,15540,37,156,193,False
2012-10-09,12,15541,43,217,260,False
2012-10-09,13,15542,54,184,238,False
2012-10-09,14,15543,43,201,244,False
2012-10-09,15,15544,59,195,254,False
2012-10-09,16,15545,70,354,424,False
2012-10-09,17,15546,73,733,806,False
2012-10-09,18,15547,26,758,784,False
2012-10-09,19,15548,31,483,514,False
2012-10-09,20,15549,30,330,360,False
2012-10-09,21,15550,16,209,225,False
2012-10-09,22,15551,7,155,162,False
2012-10-09,23,15552,8,76,84,False
2012-10-10,0,15553,0,33,33,False
2012-10-10,1,15554,2,6,8,False
2012-10-10,2,15555,2,6,8,False
2012-10-10,3,15556,0,6,6,False
2012-10-10,4,15557,0,6,6,False
2012-10-10,5,15558,2,38,40,False
2012-10-10,6,15559,3,172,175,False
2012-10-10,7,15560,9,498,507,False
2012-10-10,8,15561,33,806,839,False
2012-10-10,9,15562,35,331,366,False
2012-10-10,10,15563,27,190,217,False
2012-10-10,11,15564,53,238,291,False
2012-10-10,12,15565,78,312,390,False
2012-10-10,13,15566,60,237,297,False
2012-10-10,14,15567,63,208,271,False
2012-10-10,15,15568,58,261,319,False
2012-10-10,16,15569,92,474,566,False
2012-10-10,17,15570,91,857,948,False
2012-10-10,18,15571,57,787,844,False
2012-10-10,19,15572,32,534,566,False
2012-10-10,20,15573,21,371,392,False
2012-10-10,21,15574,18,251,269,False
2012-10-10,22,15575,27,170,197,False
2012-10-10,23,15576,17,119,136,False
2012-10-11,0,15577,1,41,42,False
2012-10-11,1,15578,1,10,11,False
2012-10-11,2,15579,4,7,11,False
2012-10-11,3,15580,0,3,3,False
2012-10-11,4,15581,0,10,10,False
2012-10-11,5,15582,0,42,42,False
2012-10-11,6,15583,1,158,159,False
2012-10-11,7,15584,11,467,478,False
2012-10-11,8,15585,25,773,798,False
2012-10-11,9,15586,27,328,355,False
2012-10-11,10,15587,39,165,204,False
2012-10-11,11,15588,76,175,251,False
2012-10-11,12,15589,47,279,326,False
2012-10-11,13,15590,48,243,291,False
2012-10-11,14,15591,78,270,348,False
2012-10-11,15,15592,102,358,460,False
2012-10-11,16,15593,68,413,481,False
2012-10-11,17,15594,90,737,827,False
2012-10-11,18,15595,64,628,692,False
2012-10-11,19,15596,81,662,743,False
2012-10-11,20,15597,27,388,415,False
2012-10-11,21,15598,24,236,260,False
2012-10-11,22,15599,10,167,177,False
2012-10-11,23,15600,10,176,186,False
2012-10-12,0,15601,8,60,68,False
2012-10-12,1,15602,8,29,37,False
2012-10-12,2,15603,0,16,16,False
2012-10-12,3,15604,0,6,6,False
2012-10-12,4,15605,0,8,8,False
2012-10-12,5,15606,2,33,35,False
2012-10-12,6,15607,3,140,143,False
2012-10-12,7,15608,8,384,392,False
2012-10-12,8,15609,34,711,745,False
2012-10-12,9,15610,26,374,400,False
2012-10-12,10,15611,75,200,275,False
2012-10-12,11,15612,61,252,313,False
2012-10-12,12,15613,75,312,387,False
2012-10-12,13,15614,81,300,381,False
2012-10-12,14,15615,109,262,371,False
2012-10-12,15,15616,138,317,455,False
2012-10-12,16,15617,108,412,520,False
2012-10-12,17,15618,131,706,837,False
2012-10-12,18,15619,76,566,642,False
2012-10-12,19,15620,40,453,493,False
2012-10-12,20,15621,28,280,308,False
2012-10-12,21,15622,21,169,190,False
2012-10-12,22,15623,17,143,160,False
2012-10-12,23,15624,11,89,100,False
2012-10-13,0,15625,31,218,249,False
2012-10-13,1,15626,23,123,146,False
2012-10-13,2,15627,7,60,67,False
2012-10-13,3,15628,2,13,15,False
2012-10-13,4,15629,2,9,11,False
2012-10-13,5,15630,0,11,11,False
2012-10-13,6,15631,5,23,28,False
2012-10-13,7,15632,10,60,70,False
2012-10-13,8,15633,23,151,174,False
2012-10-13,9,15634,46,220,266,False
2012-10-13,10,15635,82,265,347,False
2012-10-13,11,15636,192,335,527,False
2012-10-13,12,15637,202,371,573,False
2012-10-13,13,15638,235,435,670,False
2012-10-13,14,15639,243,354,597,False
2012-10-13,15,15640,251,364,615,False
2012-10-13,16,15641,294,343,637,False
2012-10-13,17,15642,193,335,528,False
2012-10-13,18,15643,174,299,473,False
2012-10-13,19,15644,73,259,332,False
2012-10-13,20,15645,57,198,255,False
2012-10-13,21,15646,47,157,204,False
2012-10-13,22,15647,33,156,189,False
2012-10-13,23,15648,27,98,125,False
2012-10-14,0,15649,8,103,111,False
2012-10-14,1,15650,16,96,112,False
2012-10-14,2,15651,8,58,66,False
2012-10-14,3,15652,3,25,28,False
2012-10-14,4,15653,2,10,12,False
2012-10-14,5,15654,5,6,11,False
2012-10-14,6,15655,4,20,24,False
2012-10-14,7,15656,7,44,51,False
2012-10-14,8,15657,28,104,132,False
2012-10-14,9,15658,62,161,223,False
2012-10-14,10,15659,150,278,428,False
2012-10-14,11,15660,156,338,494,False
2012-10-14,12,15661,200,362,562,False
2012-10-14,13,15662,218,401,619,False
2012-10-14,14,15663,249,368,617,False
2012-10-14,15,15664,213,355,568,False
2012-10-14,16,15665,203,378,581,False
2012-10-14,17,15666,193,346,539,False
2012-10-14,18,15667,134,319,453,False
2012-10-14,19,15668,68,268,336,False
2012-10-14,20,15669,48,198,246,False
2012-10-14,21,15670,40,156,196,False
2012-10-14,22,15671,38,87,125,False
2012-10-14,23,15672,27,78,105,False
2012-10-15,0,15673,17,31,48,False
2012-10-15,1,15674,5,24,29,False
2012-10-15,2,15675,1,5,6,False
2012-10-15,3,15676,2,2,4,False
2012-10-15,4,15677,1,9,10,False
2012-10-15,5,15678,2,38,40,False
2012-10-15,6,15679,6,141,147,False
2012-10-15,7,15680,15,461,476,False
2012-10-15,8,15681,24,713,737,False
2012-10-15,9,15682,31,328,359,False
2012-10-15,10,15683,43,125,168,False
2012-10-15,11,15684,88,175,263,False
2012-10-15,12,15685,73,211,284,False
2012-10-15,13,15686,37,109,146,False
2012-10-15,14,15687,57,128,185,False
2012-10-15,15,15688,70,190,260,False
2012-10-15,16,15689,76,371,447,False
2012-10-15,17,15690,96,670,766,False
2012-10-15,18,15691,52,540,592,False
2012-10-15,19,15692,12,227,239,False
2012-10-15,20,15693,19,237,256,False
2012-10-15,21,15694,16,190,206,False
2012-10-15,22,15695,8,118,126,False
2012-10-15,23,15696,9,72,81,False
2012-10-16,0,15697,3,45,48,False
2012-10-16,1,15698,4,9,13,False
2012-10-16,2,15699,2,1,3,False
2012-10-16,3,15700,0,2,2,False
2012-10-16,4,15701,0,7,7,False
2012-10-16,5,15702,5,47,52,False
2012-10-16,6,15703,4,168,172,False
2012-10-16,7,15704,20,505,525,False
2012-10-16,8,15705,35,800,835,False
2012-10-16,9,15706,32,323,355,False
2012-10-16,10,15707,65,157,222,False
2012-10-16,11,15708,56,172,228,False
2012-10-16,12,15709,69,256,325,False
2012-10-16,13,15710,68,260,328,False
2012-10-16,14,15711,94,214,308,False
2012-10-16,15,15712,76,270,346,False
2012-10-16,16,15713,79,367,446,False
2012-10-16,17,15714,104,839,943,False
2012-10-16,18,15715,71,767,838,False
2012-10-16,19,15716,40,491,531,False
2012-10-16,20,15717,35,397,432,False
2012-10-16,21,15718,19,176,195,False
2012-10-16,22,15719,18,163,181,False
2012-10-16,23,15720,23,176,199,False
2012-10-17,0,15721,1,48,49,False
2012-10-17,1,15722,3,14,17,False
2012-10-17,2,15723,4,12,16,False
2012-10-17,3,15724,0,7,7,False
2012-10-17,4,15725,0,4,4,False
2012-10-17,5,15726,2,39,41,False
2012-10-17,6,15727,7,171,178,False
2012-10-17,7,15728,15,449,464,False
2012-10-17,8,15729,38,779,817,False
2012-10-17,9,15730,38,344,382,False
2012-10-17,10,15731,60,168,228,False
2012-10-17,11,15732,78,156,234,False
2012-10-17,12,15733,71,261,332,False
2012-10-17,13,15734,73,237,310,False
2012-10-17,14,15735,82,188,270,False
2012-10-17,15,15736,62,239,301,False
2012-10-17,16,15737,70,396,466,False
2012-10-17,17,15738,122,766,888,False
2012-10-17,18,15739,90,794,884,False
2012-10-17,19,15740,49,467,516,False
2012-10-17,20,15741,54,360,414,False
2012-10-17,21,15742,28,301,329,False
2012-10-17,22,15743,17,198,215,False
2012-10-17,23,15744,15,84,99,False
2012-10-18,0,15745,4,53,57,False
2012-10-18,1,15746,0,14,14,False
2012-10-18,2,15747,1,13,14,False
2012-10-18,3,15748,0,5,5,False
2012-10-18,4,15749,0,5,5,False
2012-10-18,5,15750,1,41,42,False
2012-10-18,6,15751,3,150,153,False
2012-10-18,7,15752,20,488,508,False
2012-10-18,8,15753,31,803,834,False
2012-10-18,9,15754,41,346,387,False
2012-10-18,10,15755,60,158,218,False
2012-10-18,11,15756,79,189,268,False
2012-10-18,12,15757,93,284,377,False
2012-10-18,13,15758,96,236,332,False
2012-10-18,14,15759,94,191,285,False
2012-10-18,15,15760,69,284,353,False
2012-10-18,16,15761,94,356,450,False
2012-10-18,17,15762,102,788,890,False
2012-10-18,18,15763,68,720,788,False
2012-10-18,19,15764,42,471,513,False
2012-10-18,20,15765,39,348,387,False
2012-10-18,21,15766,38,245,283,False
2012-10-18,22,15767,27,202,229,False
2012-10-18,23,15768,6,111,117,False
2012-10-19,0,15769,5,51,56,False
2012-10-19,1,15770,4,12,16,False
2012-10-19,2,15771,1,9,10,False
2012-10-19,3,15772,0,5,5,False
2012-10-19,4,15773,1,5,6,False
2012-10-19,5,15774,1,35,36,False
2012-10-19,6,15775,5,126,131,False
2012-10-19,7,15776,5,149,154,False
2012-10-19,8,15777,20,447,467,False
2012-10-19,9,15778,26,363,389,False
2012-10-19,10,15779,26,198,224,False
2012-10-19,11,15780,41,211,252,False
2012-10-19,12,15781,74,258,332,False
2012-10-19,13,15782,87,288,375,False
2012-10-19,14,15783,88,277,365,False
2012-10-19,15,15784,93,302,395,False
2012-10-19,16,15785,131,434,565,False
2012-10-19,17,15786,48,377,425,False
2012-10-19,18,15787,21,212,233,False
2012-10-19,19,15788,19,213,232,False
2012-10-19,20,15789,13,216,229,False
2012-10-19,21,15790,17,189,206,False
2012-10-19,22,15791,14,176,190,False
2012-10-19,23,15792,13,118,131,False
2012-10-20,0,15793,13,110,123,False
2012-10-20,1,15794,2,93,95,False
2012-10-20,2,15795,9,69,78,False
2012-10-20,3,15796,2,27,29,False
2012-10-20,4,15797,9,9,18,False
2012-10-20,5,15798,6,7,13,False
2012-10-20,6,15799,5,26,31,False
2012-10-20,7,15800,6,59,65,False
2012-10-20,8,15801,29,164,193,False
2012-10-20,9,15802,106,257,363,False
2012-10-20,10,15803,111,312,423,False
2012-10-20,11,15804,204,408,612,False
2012-10-20,12,15805,267,436,703,False
2012-10-20,13,15806,273,441,714,False
2012-10-20,14,15807,335,376,711,False
2012-10-20,15,15808,308,403,711,False
2012-10-20,16,15809,325,366,691,False
2012-10-20,17,15810,347,384,731,False
2012-10-20,18,15811,165,356,521,False
2012-10-20,19,15812,77,268,345,False
2012-10-20,20,15813,61,198,259,False
2012-10-20,21,15814,72,224,296,False
2012-10-20,22,15815,47,155,202,False
2012-10-20,23,15816,27,136,163,False
2012-10-21,0,15817,35,119,154,False
2012-10-21,1,15818,20,97,117,False
2012-10-21,2,15819,44,88,132,False
2012-10-21,3,15820,12,29,41,False
2012-10-21,4,15821,8,13,21,False
2012-10-21,5,15822,6,4,10,False
2012-10-21,6,15823,8,18,26,False
2012-10-21,7,15824,13,43,56,False
2012-10-21,8,15825,39,104,143,False
2012-10-21,9,15826,77,192,269,False
2012-10-21,10,15827,167,276,443,False
2012-10-21,11,15828,191,356,547,False
2012-10-21,12,15829,236,439,675,False
2012-10-21,13,15830,243,383,626,False
2012-10-21,14,15831,235,405,640,False
2012-10-21,15,15832,240,383,623,False
2012-10-21,16,15833,182,409,591,False
2012-10-21,17,15834,153,338,491,False
2012-10-21,18,15835,71,342,413,False
2012-10-21,19,15836,50,216,266,False
2012-10-21,20,15837,35,160,195,False
2012-10-21,21,15838,42,124,166,False
2012-10-21,22,15839,18,95,113,False
2012-10-21,23,15840,7,59,66,False
2012-10-22,0,15841,3,28,31,False
2012-10-22,1,15842,0,11,11,False
2012-10-22,2,15843,1,4,5,False
2012-10-22,3,15844,1,5,6,False
2012-10-22,4,15845,1,6,7,False
2012-10-22,5,15846,2,44,46,False
2012-10-22,6,15847,4,140,144,False
2012-10-22,7,15848,15,437,452,False
2012-10-22,8,15849,32,696,728,False
2012-10-22,9,15850,25,335,360,False
2012-10-22,10,15851,51,161,212,False
2012-10-22,11,15852,63,148,211,False
2012-10-22,12,15853,52,231,283,False
2012-10-22,13,15854,88,227,315,False
2012-10-22,14,15855,73,209,282,False
2012-10-22,15,15856,74,222,296,False
2012-10-22,16,15857,80,444,524,False
2012-10-22,17,15858,84,838,922,False
2012-10-22,18,15859,60,726,786,False
2012-10-22,19,15860,36,478,514,False
2012-10-22,20,15861,21,382,403,False
2012-10-22,21,15862,19,155,174,False
2012-10-22,22,15863,25,158,183,False
2012-10-22,23,15864,20,143,163,False
2012-10-23,0,15865,5,32,37,False
2012-10-23,1,15866,1,16,17,False
2012-10-23,2,15867,1,6,7,False
2012-10-23,3,15868,0,1,1,False
2012-10-23,4,15869,1,6,7,False
2012-10-23,5,15870,1,49,50,False
2012-10-23,6,15871,6,152,158,False
2012-10-23,7,15872,12,519,531,False
2012-10-23,8,15873,28,733,761,False
2012-10-23,9,15874,29,305,334,False
2012-10-23,10,15875,50,171,221,False
2012-10-23,11,15876,52,201,253,False
2012-10-23,12,15877,80,298,378,False
2012-10-23,13,15878,59,244,303,False
2012-10-23,14,15879,67,229,296,False
2012-10-23,15,15880,76,270,346,False
2012-10-23,16,15881,108,433,541,False
2012-10-23,17,15882,67,871,938,False
2012-10-23,18,15883,64,762,826,False
2012-10-23,19,15884,25,457,482,False
2012-10-23,20,15885,45,334,379,False
2012-10-23,21,15886,35,260,295,False
2012-10-23,22,15887,20,174,194,False
2012-10-23,23,15888,9,102,111,False
2012-10-24,0,15889,7,39,46,False
2012-10-24,1,15890,4,23,27,False
2012-10-24,2,15891,0,6,6,False
2012-10-24,3,15892,0,4,4,False
2012-10-24,4,15893,1,5,6,False
2012-10-24,5,15894,1,52,53,False
2012-10-24,6,15895,11,162,173,False
2012-10-24,7,15896,20,506,526,False
2012-10-24,8,15897,24,777,801,False
2012-10-24,9,15898,24,349,373,False
2012-10-24,10,15899,29,142,171,False
2012-10-24,11,15900,47,189,236,False
2012-10-24,12,15901,48,268,316,False
2012-10-24,13,15902,65,241,306,False
2012-10-24,14,15903,64,237,301,False
2012-10-24,15,15904,63,245,308,False
2012-10-24,16,15905,67,465,532,False
2012-10-24,17,15906,87,876,963,False
2012-10-24,18,15907,63,795,858,False
2012-10-24,19,15908,50,522,572,False
2012-10-24,20,15909,45,396,441,False
2012-10-24,21,15910,33,280,313,False
2012-10-24,22,15911,30,208,238,False
2012-10-24,23,15912,12,111,123,False
2012-10-25,0,15913,19,57,76,False
2012-10-25,1,15914,6,22,28,False
2012-10-25,2,15915,3,15,18,False
2012-10-25,3,15916,0,8,8,False
2012-10-25,4,15917,1,4,5,False
2012-10-25,5,15918,2,53,55,False
2012-10-25,6,15919,3,168,171,False
2012-10-25,7,15920,18,477,495,False
2012-10-25,8,15921,33,746,779,False
2012-10-25,9,15922,23,320,343,False
2012-10-25,10,15923,53,172,225,False
2012-10-25,11,15924,57,181,238,False
2012-10-25,12,15925,61,258,319,False
2012-10-25,13,15926,49,264,313,False
2012-10-25,14,15927,71,214,285,False
2012-10-25,15,15928,63,242,305,False
2012-10-25,16,15929,92,407,499,False
2012-10-25,17,15930,112,774,886,False
2012-10-25,18,15931,77,732,809,False
2012-10-25,19,15932,45,497,542,False
2012-10-25,20,15933,28,319,347,False
2012-10-25,21,15934,24,247,271,False
2012-10-25,22,15935,22,185,207,False
2012-10-25,23,15936,13,122,135,False
2012-10-26,0,15937,6,65,71,False
2012-10-26,1,15938,4,32,36,False
2012-10-26,2,15939,4,15,19,False
2012-10-26,3,15940,5,8,13,False
2012-10-26,4,15941,1,4,5,False
2012-10-26,5,15942,3,47,50,False
2012-10-26,6,15943,2,142,144,False
2012-10-26,7,15944,13,408,421,False
2012-10-26,8,15945,20,714,734,False
2012-10-26,9,15946,56,347,403,False
2012-10-26,10,15947,41,156,197,False
2012-10-26,11,15948,68,222,290,False
2012-10-26,12,15949,90,302,392,False
2012-10-26,13,15950,77,260,337,False
2012-10-26,14,15951,99,252,351,False
2012-10-26,15,15952,142,306,448,False
2012-10-26,16,15953,137,445,582,False
2012-10-26,17,15954,125,692,817,False
2012-10-26,18,15955,81,584,665,False
2012-10-26,19,15956,72,399,471,False
2012-10-26,20,15957,40,271,311,False
2012-10-26,21,15958,40,252,292,False
2012-10-26,22,15959,37,180,217,False
2012-10-26,23,15960,19,159,178,False
2012-10-27,0,15961,10,132,142,False
2012-10-27,1,15962,23,123,146,False
2012-10-27,2,15963,19,71,90,False
2012-10-27,3,15964,5,21,26,False
2012-10-27,4,15965,1,12,13,False
2012-10-27,5,15966,2,7,9,False
2012-10-27,6,15967,2,29,31,False
2012-10-27,7,15968,7,79,86,False
2012-10-27,8,15969,26,187,213,False
2012-10-27,9,15970,88,240,328,False
2012-10-27,10,15971,165,314,479,False
2012-10-27,11,15972,197,388,585,False
2012-10-27,12,15973,264,404,668,False
2012-10-27,13,15974,310,450,760,False
2012-10-27,14,15975,325,425,750,False
2012-10-27,15,15976,310,401,711,False
2012-10-27,16,15977,257,355,612,False
2012-10-27,17,15978,248,370,618,False
2012-10-27,18,15979,138,318,456,False
2012-10-27,19,15980,67,233,300,False
2012-10-27,20,15981,58,238,296,False
2012-10-27,21,15982,49,160,209,False
2012-10-27,22,15983,41,116,157,False
2012-10-27,23,15984,31,136,167,False
2012-10-28,0,15985,20,97,117,False
2012-10-28,1,15986,22,111,133,False
2012-10-28,2,15987,17,99,116,False
2012-10-28,3,15988,18,61,79,False
2012-10-28,4,15989,1,19,20,False
2012-10-28,5,15990,6,22,28,False
2012-10-28,6,15991,7,32,39,False
2012-10-28,7,15992,17,48,65,False
2012-10-28,8,15993,55,118,173,False
2012-10-28,9,15994,124,206,330,False
2012-10-28,10,15995,120,314,434,False
2012-10-28,11,15996,110,352,462,False
2012-10-28,12,15997,118,373,491,False
2012-10-28,13,15998,75,316,391,False
2012-10-28,14,15999,98,304,402,False
2012-10-28,15,16000,76,225,301,False
2012-10-28,16,16001,42,251,293,False
2012-10-28,17,16002,37,188,225,False
2012-10-28,18,16003,18,136,154,False
2012-10-28,19,16004,7,47,54,False
2012-10-28,20,16005,4,51,55,False
2012-10-28,21,16006,2,44,46,False
2012-10-28,22,16007,2,35,37,False
2012-10-28,23,16008,2,12,14,False
2012-10-29,0,16009,2,20,22,False
2012-10-29,1,16010,7,27,34,True
2012-10-29,2,16011,5,18,23,True
2012-10-29,3,16012,3,9,12,True
2012-10-29,4,16013,1,5,6,True
2012-10-29,5,16014,1,18,19,True
2012-10-29,6,16015,4,72,76,True
2012-10-29,7,16016,11,201,212,True
2012-10-29,8,16017,22,337,359,True
2012-10-29,9,16018,31,188,219,True
2012-10-29,10,16019,46,127,173,True
2012-10-29,11,16020,60,149,209,True
2012-10-29,12,16021,68,185,253,True
2012-10-29,13,16022,72,181,253,True
2012-10-29,14,16023,76,165,241,True
2012-10-29,15,16024,75,176,251,True
2012-10-29,16,16025,74,238,312,True
2012-10-29,17,16026,74,387,461,True
2012-10-29,18,16027,61,364,425,True
2012-10-29,19,16028,49,263,312,True
2012-10-29,20,16029,36,190,226,True
2012-10-29,21,16030,28,144,172,True
2012-10-29,22,16031,22,109,131,True
2012-10-29,23,16032,15,73,88,True
2012-10-30,0,16033,10,44,54,True
2012-10-30,1,16034,7,27,34,True
2012-10-30,2,16035,5,18,23,True
2012-10-30,3,16036,3,9,12,True
2012-10-30,4,16037,1,5,6,True
2012-10-30,5,16038,1,18,19,True
2012-10-30,6,16039,4,72,76,True
2012-10-30,7,16040,11,201,212,True
2012-10-30,8,16041,22,337,359,True
2012-10-30,9,16042,31,188,219,True
2012-10-30,10,16043,46,127,173,True
2012-10-30,11,16044,60,149,209,True
2012-10-30,12,16045,68,185,253,True
2012-10-30,13,16046,11,105,116,False
2012-10-30,14,16047,8,118,126,False
2012-10-30,15,16048,10,114,124,False
2012-10-30,16,16049,15,83,98,False
2012-10-30,17,16050,19,105,124,False
2012-10-30,18,16051,4,139,143,False
2012-10-30,19,16052,6,109,115,False
2012-10-30,20,16053,5,76,81,False
2012-10-30,21,16054,4,60,64,False
2012-10-30,22,16055,2,64,66,False
2012-10-30,23,16056,3,36,39,False
2012-10-31,0,16057,0,16,16,False
2012-10-31,1,16058,0,8,8,False
2012-10-31,2,16059,0,7,7,False
2012-10-31,3,16060,0,3,3,False
2012-10-31,4,16061,0,5,5,False
2012-10-31,5,16062,0,24,24,False
2012-10-31,6,16063,0,116,116,False
2012-10-31,7,16064,3,334,337,False
2012-10-31,8,16065,6,615,621,False
2012-10-31,9,16066,17,280,297,False
2012-10-31,10,16067,21,147,168,False
2012-10-31,11,16068,37,152,189,False
2012-10-31,12,16069,44,197,241,False
2012-10-31,13,16070,22,191,213,False
2012-10-31,14,16071,45,179,224,False
2012-10-31,15,16072,33,197,230,False
2012-10-31,16,16073,51,373,424,False
2012-10-31,17,16074,39,684,723,False
2012-10-31,18,16075,28,556,584,False
2012-10-31,19,16076,27,383,410,False
2012-10-31,20,16077,9,259,268,False
2012-10-31,21,16078,12,180,192,False
2012-10-31,22,16079,18,147,165,False
2012-10-31,23,16080,7,94,101,False
2012-11-01,0,16081,8,52,60,False
2012-11-01,1,16082,8,22,30,False
2012-11-01,2,16083,10,10,20,False
2012-11-01,3,16084,5,10,15,False
2012-11-01,4,16085,2,8,10,False
2012-11-01,5,16086,1,39,40,False
2012-11-01,6,16087,2,146,148,False
2012-11-01,7,16088,6,414,420,False
2012-11-01,8,16089,12,668,680,False
2012-11-01,9,16090,21,310,331,False
2012-11-01,10,16091,13,133,146,False
2012-11-01,11,16092,14,156,170,False
2012-11-01,12,16093,23,198,221,False
2012-11-01,13,16094,49,199,248,False
2012-11-01,14,16095,31,154,185,False
2012-11-01,15,16096,35,179,214,False
2012-11-01,16,16097,31,313,344,False
2012-11-01,17,16098,37,652,689,False
2012-11-01,18,16099,50,628,678,False
2012-11-01,19,16100,28,424,452,False
2012-11-01,20,16101,16,280,296,False
2012-11-01,21,16102,29,238,267,False
2012-11-01,22,16103,27,175,202,False
2012-11-01,23,16104,8,112,120,False
2012-11-02,0,16105,10,40,50,False
2012-11-02,1,16106,5,19,24,False
2012-11-02,2,16107,3,7,10,False
2012-11-02,3,16108,0,3,3,False
2012-11-02,4,16109,1,6,7,False
2012-11-02,5,16110,1,25,26,False
2012-11-02,6,16111,2,120,122,False
2012-11-02,7,16112,8,349,357,False
2012-11-02,8,16113,31,656,687,False
2012-11-02,9,16114,27,355,382,False
2012-11-02,10,16115,21,183,204,False
2012-11-02,11,16116,42,179,221,False
2012-11-02,12,16117,52,240,292,False
2012-11-02,13,16118,64,230,294,False
2012-11-02,14,16119,63,199,262,False
2012-11-02,15,16120,51,255,306,False
2012-11-02,16,16121,48,373,421,False
2012-11-02,17,16122,57,581,638,False
2012-11-02,18,16123,32,490,522,False
2012-11-02,19,16124,38,336,374,False
2012-11-02,20,16125,14,207,221,False
2012-11-02,21,16126,23,133,156,False
2012-11-02,22,16127,14,135,149,False
2012-11-02,23,16128,11,108,119,False
2012-11-03,0,16129,9,99,108,False
2012-11-03,1,16130,6,83,89,False
2012-11-03,2,16131,10,36,46,False
2012-11-03,3,16132,6,22,28,False
2012-11-03,4,16133,8,8,16,False
2012-11-03,5,16134,1,8,9,False
2012-11-03,6,16135,4,17,21,False
2012-11-03,7,16136,1,58,59,False
2012-11-03,8,16137,10,132,142,False
2012-11-03,9,16138,31,188,219,False
2012-11-03,10,16139,68,260,328,False
2012-11-03,11,16140,56,284,340,False
2012-11-03,12,16141,74,320,394,False
2012-11-03,13,16142,110,339,449,False
2012-11-03,14,16143,136,319,455,False
2012-11-03,15,16144,117,331,448,False
2012-11-03,16,16145,108,292,400,False
2012-11-03,17,16146,112,298,410,False
2012-11-03,18,16147,58,239,297,False
2012-11-03,19,16148,22,217,239,False
2012-11-03,20,16149,23,158,181,False
2012-11-03,21,16150,31,135,166,False
2012-11-03,22,16151,13,133,146,False
2012-11-03,23,16152,15,133,148,False
2012-11-04,0,16153,5,97,102,False
2012-11-04,1,16154,26,139,165,False
2012-11-04,2,16155,6,31,37,False
2012-11-04,3,16156,1,10,11,False
2012-11-04,4,16157,2,7,9,False
2012-11-04,5,16158,0,5,5,False
2012-11-04,6,16159,2,14,16,False
2012-11-04,7,16160,11,39,50,False
2012-11-04,8,16161,34,115,149,False
2012-11-04,9,16162,56,161,217,False
2012-11-04,10,16163,73,287,360,False
2012-11-04,11,16164,134,311,445,False
2012-11-04,12,16165,150,354,504,False
2012-11-04,13,16166,122,371,493,False
2012-11-04,14,16167,149,360,509,False
2012-11-04,15,16168,149,300,449,False
2012-11-04,16,16169,119,316,435,False
2012-11-04,17,16170,57,270,327,False
2012-11-04,18,16171,31,206,237,False
2012-11-04,19,16172,24,203,227,False
2012-11-04,20,16173,7,134,141,False
2012-11-04,21,16174,16,71,87,False
2012-11-04,22,16175,15,64,79,False
2012-11-04,23,16176,12,41,53,False
2012-11-05,0,16177,3,20,23,False
2012-11-05,1,16178,0,8,8,False
2012-11-05,2,16179,2,4,6,False
2012-11-05,3,16180,1,3,4,False
2012-11-05,4,16181,5,11,16,False
2012-11-05,5,16182,1,38,39,False
2012-11-05,6,16183,4,135,139,False
2012-11-05,7,16184,8,453,461,False
2012-11-05,8,16185,19,629,648,False
2012-11-05,9,16186,18,239,257,False
2012-11-05,10,16187,30,112,142,False
2012-11-05,11,16188,31,119,150,False
2012-11-05,12,16189,38,206,244,False
2012-11-05,13,16190,39,183,222,False
2012-11-05,14,16191,31,165,196,False
2012-11-05,15,16192,24,207,231,False
2012-11-05,16,16193,35,325,360,False
2012-11-05,17,16194,34,604,638,False
2012-11-05,18,16195,19,523,542,False
2012-11-05,19,16196,11,361,372,False
2012-11-05,20,16197,13,228,241,False
2012-11-05,21,16198,8,144,152,False
2012-11-05,22,16199,4,111,115,False
2012-11-05,23,16200,0,53,53,False
2012-11-06,0,16201,1,18,19,False
2012-11-06,1,16202,0,8,8,False
2012-11-06,2,16203,0,2,2,False
2012-11-06,3,16204,0,4,4,False
2012-11-06,4,16205,0,7,7,False
2012-11-06,5,16206,1,40,41,False
2012-11-06,6,16207,6,143,149,False
2012-11-06,7,16208,9,378,387,False
2012-11-06,8,16209,20,568,588,False
2012-11-06,9,16210,25,338,363,False
2012-11-06,10,16211,41,189,230,False
2012-11-06,11,16212,39,177,216,False
2012-11-06,12,16213,31,217,248,False
2012-11-06,13,16214,46,232,278,False
2012-11-06,14,16215,44,196,240,False
2012-11-06,15,16216,45,227,272,False
2012-11-06,16,16217,33,369,402,False
2012-11-06,17,16218,30,597,627,False
2012-11-06,18,16219,20,477,497,False
2012-11-06,19,16220,15,356,371,False
2012-11-06,20,16221,10,218,228,False
2012-11-06,21,16222,14,137,151,False
2012-11-06,22,16223,17,136,153,False
2012-11-06,23,16224,19,186,205,False
2012-11-07,0,16225,49,234,283,False
2012-11-07,1,16226,6,86,92,False
2012-11-07,2,16227,6,68,74,False
2012-11-07,3,16228,2,9,11,False
2012-11-07,4,16229,0,9,9,False
2012-11-07,5,16230,0,27,27,False
2012-11-07,6,16231,3,115,118,False
2012-11-07,7,16232,5,314,319,False
2012-11-07,8,16233,18,583,601,False
2012-11-07,9,16234,17,351,368,False
2012-11-07,10,16235,27,151,178,False
2012-11-07,11,16236,15,132,147,False
2012-11-07,12,16237,24,188,212,False
2012-11-07,13,16238,23,158,181,False
2012-11-07,14,16239,19,142,161,False
2012-11-07,15,16240,20,178,198,False
2012-11-07,16,16241,23,250,273,False
2012-11-07,17,16242,16,501,517,False
2012-11-07,18,16243,17,448,465,False
2012-11-07,19,16244,17,302,319,False
2012-11-07,20,16245,7,249,256,False
2012-11-07,21,16246,5,121,126,False
2012-11-07,22,16247,4,56,60,False
2012-11-07,23,16248,3,37,40,False
2012-11-08,0,16249,1,14,15,False
2012-11-08,1,16250,1,11,12,False
2012-11-08,2,16251,1,5,6,False
2012-11-08,3,16252,3,9,12,True
2012-11-08,4,16253,1,9,10,False
2012-11-08,5,16254,0,35,35,False
2012-11-08,6,16255,2,122,124,False
2012-11-08,7,16256,12,411,423,False
2012-11-08,8,16257,16,652,668,False
2012-11-08,9,16258,22,253,275,False
2012-11-08,10,16259,13,148,161,False
2012-11-08,11,16260,16,155,171,False
2012-11-08,12,16261,33,202,235,False
2012-11-08,13,16262,33,195,228,False
2012-11-08,14,16263,33,149,182,False
2012-11-08,15,16264,32,201,233,False
2012-11-08,16,16265,18,321,339,False
2012-11-08,17,16266,36,556,592,False
2012-11-08,18,16267,16,491,507,False
2012-11-08,19,16268,14,359,373,False
2012-11-08,20,16269,10,235,245,False
2012-11-08,21,16270,11,222,233,False
2012-11-08,22,16271,14,147,161,False
2012-11-08,23,16272,5,82,87,False
2012-11-09,0,16273,9,46,55,False
2012-11-09,1,16274,3,17,20,False
2012-11-09,2,16275,1,11,12,False
2012-11-09,3,16276,3,6,9,False
2012-11-09,4,16277,0,14,14,False
2012-11-09,5,16278,2,25,27,False
2012-11-09,6,16279,5,126,131,False
2012-11-09,7,16280,9,332,341,False
2012-11-09,8,16281,25,668,693,False
2012-11-09,9,16282,23,304,327,False
2012-11-09,10,16283,34,163,197,False
2012-11-09,11,16284,66,185,251,False
2012-11-09,12,16285,48,214,262,False
2012-11-09,13,16286,62,237,299,False
2012-11-09,14,16287,67,207,274,False
2012-11-09,15,16288,78,278,356,False
2012-11-09,16,16289,57,377,434,False
2012-11-09,17,16290,61,593,654,False
2012-11-09,18,16291,46,450,496,False
2012-11-09,19,16292,30,331,361,False
2012-11-09,20,16293,20,235,255,False
2012-11-09,21,16294,23,176,199,False
2012-11-09,22,16295,17,146,163,False
2012-11-09,23,16296,20,142,162,False
2012-11-10,0,16297,16,106,122,False
2012-11-10,1,16298,8,68,76,False
2012-11-10,2,16299,2,42,44,False
2012-11-10,3,16300,9,11,20,False
2012-11-10,4,16301,2,4,6,False
2012-11-10,5,16302,1,9,10,False
2012-11-10,6,16303,5,11,16,False
2012-11-10,7,16304,14,57,71,False
2012-11-10,8,16305,16,130,146,False
2012-11-10,9,16306,43,216,259,False
2012-11-10,10,16307,86,264,350,False
2012-11-10,11,16308,143,323,466,False
2012-11-10,12,16309,258,348,606,False
2012-11-10,13,16310,268,383,651,False
2012-11-10,14,16311,280,347,627,False
2012-11-10,15,16312,216,351,567,False
2012-11-10,16,16313,227,378,605,False
2012-11-10,17,16314,183,318,501,False
2012-11-10,18,16315,103,256,359,False
2012-11-10,19,16316,55,228,283,False
2012-11-10,20,16317,39,153,192,False
2012-11-10,21,16318,51,169,220,False
2012-11-10,22,16319,39,154,193,False
2012-11-10,23,16320,26,120,146,False
2012-11-11,0,16321,14,110,124,False
2012-11-11,1,16322,26,82,108,False
2012-11-11,2,16323,12,58,70,False
2012-11-11,3,16324,9,39,48,False
2012-11-11,4,16325,5,6,11,False
2012-11-11,5,16326,0,12,12,False
2012-11-11,6,16327,3,16,19,False
2012-11-11,7,16328,12,56,68,False
2012-11-11,8,16329,32,87,119,False
2012-11-11,9,16330,94,179,273,False
2012-11-11,10,16331,133,272,405,False
2012-11-11,11,16332,180,324,504,False
2012-11-11,12,16333,195,390,585,False
2012-11-11,13,16334,262,424,686,False
2012-11-11,14,16335,292,362,654,False
2012-11-11,15,16336,304,420,724,False
2012-11-11,16,16337,260,393,653,False
2012-11-11,17,16338,151,342,493,False
2012-11-11,18,16339,102,303,405,False
2012-11-11,19,16340,69,208,277,False
2012-11-11,20,16341,54,146,200,False
2012-11-11,21,16342,44,127,171,False
2012-11-11,22,16343,21,113,134,False
2012-11-11,23,16344,16,93,109,False
2012-11-12,0,16345,6,43,49,False
2012-11-12,1,16346,4,26,30,False
2012-11-12,2,16347,6,14,20,False
2012-11-12,3,16348,1,3,4,False
2012-11-12,4,16349,1,3,4,False
2012-11-12,5,16350,1,23,24,False
2012-11-12,6,16351,7,64,71,False
2012-11-12,7,16352,16,248,264,False
2012-11-12,8,16353,50,490,540,False
2012-11-12,9,16354,60,337,397,False
2012-11-12,10,16355,82,184,266,False
2012-11-12,11,16356,112,255,367,False
2012-11-12,12,16357,105,314,419,False
2012-11-12,13,16358,108,312,420,False
2012-11-12,14,16359,134,310,444,False
2012-11-12,15,16360,102,280,382,False
2012-11-12,16,16361,87,347,434,False
2012-11-12,17,16362,66,530,596,False
2012-11-12,18,16363,65,486,551,False
2012-11-12,19,16364,30,323,353,False
2012-11-12,20,16365,31,273,304,False
2012-11-12,21,16366,10,145,155,False
2012-11-12,22,16367,12,100,112,False
2012-11-12,23,16368,1,62,63,False
2012-11-13,0,16369,5,18,23,False
2012-11-13,1,16370,0,5,5,False
2012-11-13,2,16371,7,4,11,False
2012-11-13,3,16372,2,3,5,False
2012-11-13,4,16373,0,9,9,False
2012-11-13,5,16374,0,18,18,False
2012-11-13,6,16375,2,48,50,False
2012-11-13,7,16376,1,106,107,False
2012-11-13,8,16377,4,207,211,False
2012-11-13,9,16378,1,109,110,False
2012-11-13,10,16379,10,84,94,False
2012-11-13,11,16380,22,133,155,False
2012-11-13,12,16381,16,180,196,False
2012-11-13,13,16382,30,188,218,False
2012-11-13,14,16383,34,169,203,False
2012-11-13,15,16384,33,184,217,False
2012-11-13,16,16385,28,282,310,False
2012-11-13,17,16386,33,575,608,False
2012-11-13,18,16387,45,514,559,False
2012-11-13,19,16388,12,344,356,False
2012-11-13,20,16389,12,211,223,False
2012-11-13,21,16390,9,178,187,False
2012-11-13,22,16391,15,120,135,False
2012-11-13,23,16392,6,78,84,False
2012-11-14,0,16393,4,20,24,False
2012-11-14,1,16394,2,10,12,False
2012-11-14,2,16395,0,1,1,False
2012-11-14,3,16396,0,5,5,False
2012-11-14,4,16397,0,6,6,False
2012-11-14,5,16398,0,39,39,False
2012-11-14,6,16399,4,142,146,False
2012-11-14,7,16400,10,405,415,False
2012-11-14,8,16401,27,664,691,False
2012-11-14,9,16402,22,310,332,False
2012-11-14,10,16403,18,153,171,False
2012-11-14,11,16404,25,126,151,False
2012-11-14,12,16405,40,200,240,False
2012-11-14,13,16406,32,182,214,False
2012-11-14,14,16407,20,161,181,False
2012-11-14,15,16408,32,228,260,False
2012-11-14,16,16409,31,290,321,False
2012-11-14,17,16410,19,564,583,False
2012-11-14,18,16411,24,543,567,False
2012-11-14,19,16412,28,368,396,False
2012-11-14,20,16413,15,252,267,False
2012-11-14,21,16414,5,208,213,False
2012-11-14,22,16415,6,167,173,False
2012-11-14,23,16416,9,78,87,False
2012-11-15,0,16417,1,33,34,False
2012-11-15,1,16418,2,14,16,False
2012-11-15,2,16419,0,7,7,False
2012-11-15,3,16420,0,2,2,False
2012-11-15,4,16421,0,5,5,False
2012-11-15,5,16422,3,34,37,False
2012-11-15,6,16423,1,146,147,False
2012-11-15,7,16424,7,403,410,False
2012-11-15,8,16425,21,625,646,False
2012-11-15,9,16426,17,306,323,False
2012-11-15,10,16427,11,142,153,False
2012-11-15,11,16428,28,138,166,False
2012-11-15,12,16429,29,184,213,False
2012-11-15,13,16430,20,197,217,False
2012-11-15,14,16431,27,174,201,False
2012-11-15,15,16432,26,191,217,False
2012-11-15,16,16433,24,318,342,False
2012-11-15,17,16434,22,541,563,False
2012-11-15,18,16435,10,563,573,False
2012-11-15,19,16436,11,375,386,False
2012-11-15,20,16437,23,262,285,False
2012-11-15,21,16438,20,204,224,False
2012-11-15,22,16439,10,143,153,False
2012-11-15,23,16440,7,118,125,False
2012-11-16,0,16441,7,58,65,False
2012-11-16,1,16442,5,16,21,False
2012-11-16,2,16443,0,9,9,False
2012-11-16,3,16444,0,6,6,False
2012-11-16,4,16445,0,5,5,False
2012-11-16,5,16446,2,34,36,False
2012-11-16,6,16447,4,126,130,False
2012-11-16,7,16448,5,362,367,False
2012-11-16,8,16449,17,694,711,False
2012-11-16,9,16450,21,330,351,False
2012-11-16,10,16451,33,165,198,False
2012-11-16,11,16452,33,185,218,False
2012-11-16,12,16453,28,262,290,False
2012-11-16,13,16454,52,226,278,False
2012-11-16,14,16455,47,204,251,False
2012-11-16,15,16456,30,237,267,False
2012-11-16,16,16457,33,350,383,False
2012-11-16,17,16458,41,539,580,False
2012-11-16,18,16459,22,483,505,False
2012-11-16,19,16460,26,306,332,False
2012-11-16,20,16461,20,207,227,False
2012-11-16,21,16462,21,157,178,False
2012-11-16,22,16463,23,139,162,False
2012-11-16,23,16464,14,114,128,False
2012-11-17,0,16465,11,95,106,False
2012-11-17,1,16466,13,74,87,False
2012-11-17,2,16467,8,41,49,False
2012-11-17,3,16468,2,19,21,False
2012-11-17,4,16469,1,6,7,False
2012-11-17,5,16470,1,10,11,False
2012-11-17,6,16471,0,21,21,False
2012-11-17,7,16472,8,70,78,False
2012-11-17,8,16473,30,138,168,False
2012-11-17,9,16474,48,200,248,False
2012-11-17,10,16475,62,258,320,False
2012-11-17,11,16476,80,343,423,False
2012-11-17,12,16477,117,359,476,False
2012-11-17,13,16478,179,346,525,False
2012-11-17,14,16479,175,380,555,False
2012-11-17,15,16480,175,374,549,False
2012-11-17,16,16481,144,325,469,False
2012-11-17,17,16482,101,302,403,False
2012-11-17,18,16483,34,237,271,False
2012-11-17,19,16484,45,208,253,False
2012-11-17,20,16485,30,142,172,False
2012-11-17,21,16486,15,124,139,False
2012-11-17,22,16487,15,130,145,False
2012-11-17,23,16488,19,114,133,False
2012-11-18,0,16489,11,118,129,False
2012-11-18,1,16490,14,81,95,False
2012-11-18,2,16491,8,65,73,False
2012-11-18,3,16492,9,37,46,False
2012-11-18,4,16493,4,8,12,False
2012-11-18,5,16494,5,7,12,False
2012-11-18,6,16495,2,13,15,False
2012-11-18,7,16496,3,39,42,False
2012-11-18,8,16497,19,100,119,False
2012-11-18,9,16498,49,155,204,False
2012-11-18,10,16499,79,250,329,False
2012-11-18,11,16500,92,267,359,False
2012-11-18,12,16501,101,341,442,False
2012-11-18,13,16502,113,334,447,False
2012-11-18,14,16503,125,303,428,False
2012-11-18,15,16504,89,318,407,False
2012-11-18,16,16505,59,313,372,False
2012-11-18,17,16506,48,232,280,False
2012-11-18,18,16507,36,240,276,False
2012-11-18,19,16508,16,194,210,False
2012-11-18,20,16509,9,120,129,False
2012-11-18,21,16510,17,93,110,False
2012-11-18,22,16511,8,66,74,False
2012-11-18,23,16512,6,53,59,False
2012-11-19,0,16513,5,22,27,False
2012-11-19,1,16514,0,19,19,False
2012-11-19,2,16515,0,5,5,False
2012-11-19,3,16516,0,2,2,False
2012-11-19,4,16517,1,11,12,False
2012-11-19,5,16518,1,38,39,False
2012-11-19,6,16519,3,128,131,False
2012-11-19,7,16520,5,381,386,False
2012-11-19,8,16521,13,650,663,False
2012-11-19,9,16522,18,260,278,False
2012-11-19,10,16523,33,106,139,False
2012-11-19,11,16524,33,164,197,False
2012-11-19,12,16525,35,207,242,False
2012-11-19,13,16526,46,205,251,False
2012-11-19,14,16527,47,170,217,False
2012-11-19,15,16528,44,213,257,False
2012-11-19,16,16529,55,325,380,False
2012-11-19,17,16530,33,586,619,False
2012-11-19,18,16531,21,559,580,False
2012-11-19,19,16532,25,381,406,False
2012-11-19,20,16533,7,252,259,False
2012-11-19,21,16534,15,188,203,False
2012-11-19,22,16535,7,106,113,False
2012-11-19,23,16536,2,72,74,False
2012-11-20,0,16537,3,26,29,False
2012-11-20,1,16538,3,10,13,False
2012-11-20,2,16539,0,5,5,False
2012-11-20,3,16540,0,2,2,False
2012-11-20,4,16541,0,6,6,False
2012-11-20,5,16542,2,32,34,False
2012-11-20,6,16543,2,146,148,False
2012-11-20,7,16544,7,411,418,False
2012-11-20,8,16545,16,649,665,False
2012-11-20,9,16546,28,298,326,False
2012-11-20,10,16547,32,144,176,False
2012-11-20,11,16548,45,160,205,False
2012-11-20,12,16549,70,243,313,False
2012-11-20,13,16550,49,218,267,False
2012-11-20,14,16551,47,177,224,False
2012-11-20,15,16552,61,226,287,False
2012-11-20,16,16553,60,335,395,False
2012-11-20,17,16554,37,553,590,False
2012-11-20,18,16555,16,534,550,False
2012-11-20,19,16556,23,361,384,False
2012-11-20,20,16557,11,224,235,False
2012-11-20,21,16558,14,143,157,False
2012-11-20,22,16559,7,115,122,False
2012-11-20,23,16560,1,82,83,False
2012-11-21,0,16561,1,25,26,False
2012-11-21,1,16562,1,13,14,False
2012-11-21,2,16563,2,6,8,False
2012-11-21,3,16564,0,2,2,False
2012-11-21,4,16565,0,10,10,False
2012-11-21,5,16566,1,28,29,False
2012-11-21,6,16567,2,99,101,False
2012-11-21,7,16568,11,262,273,False
2012-11-21,8,16569,12,539,551,False
2012-11-21,9,16570,45,320,365,False
2012-11-21,10,16571,22,150,172,False
2012-11-21,11,16572,43,198,241,False
2012-11-21,12,16573,74,270,344,False
2012-11-21,13,16574,70,295,365,False
2012-11-21,14,16575,84,329,413,False
2012-11-21,15,16576,68,381,449,False
2012-11-21,16,16577,59,410,469,False
2012-11-21,17,16578,41,333,374,False
2012-11-21,18,16579,24,287,311,False
2012-11-21,19,16580,23,220,243,False
2012-11-21,20,16581,11,125,136,False
2012-11-21,21,16582,8,97,105,False
2012-11-21,22,16583,6,82,88,False
2012-11-21,23,16584,7,50,57,False
2012-11-22,0,16585,3,43,46,False
2012-11-22,1,16586,5,37,42,False
2012-11-22,2,16587,3,15,18,False
2012-11-22,3,16588,0,6,6,False
2012-11-22,4,16589,1,2,3,False
2012-11-22,5,16590,2,6,8,False
2012-11-22,6,16591,2,15,17,False
2012-11-22,7,16592,7,49,56,False
2012-11-22,8,16593,20,77,97,False
2012-11-22,9,16594,25,94,119,False
2012-11-22,10,16595,65,154,219,False
2012-11-22,11,16596,89,143,232,False
2012-11-22,12,16597,117,145,262,False
2012-11-22,13,16598,125,144,269,False
2012-11-22,14,16599,125,95,220,False
2012-11-22,15,16600,132,96,228,False
2012-11-22,16,16601,101,81,182,False
2012-11-22,17,16602,66,43,109,False
2012-11-22,18,16603,16,54,70,False
2012-11-22,19,16604,13,31,44,False
2012-11-22,20,16605,15,37,52,False
2012-11-22,21,16606,7,39,46,False
2012-11-22,22,16607,8,36,44,False
2012-11-22,23,16608,8,28,36,False
2012-11-23,0,16609,0,32,32,False
2012-11-23,1,16610,2,11,13,False
2012-11-23,2,16611,1,4,5,False
2012-11-23,3,16612,1,0,1,False
2012-11-23,4,16613,1,3,4,False
2012-11-23,5,16614,0,10,10,False
2012-11-23,6,16615,0,20,20,False
2012-11-23,7,16616,5,72,77,False
2012-11-23,8,16617,11,83,94,False
2012-11-23,9,16618,32,80,112,False
2012-11-23,10,16619,87,114,201,False
2012-11-23,11,16620,121,130,251,False
2012-11-23,12,16621,186,193,379,False
2012-11-23,13,16622,224,200,424,False
2012-11-23,14,16623,240,195,435,False
2012-11-23,15,16624,233,214,447,False
2012-11-23,16,16625,158,199,357,False
2012-11-23,17,16626,117,183,300,False
2012-11-23,18,16627,50,158,208,False
2012-11-23,19,16628,33,121,154,False
2012-11-23,20,16629,42,100,142,False
2012-11-23,21,16630,23,75,98,False
2012-11-23,22,16631,16,63,79,False
2012-11-23,23,16632,20,47,67,False
2012-11-24,0,16633,9,33,42,False
2012-11-24,1,16634,1,19,20,False
2012-11-24,2,16635,10,22,32,False
2012-11-24,3,16636,6,5,11,False
2012-11-24,4,16637,1,2,3,False
2012-11-24,5,16638,1,2,3,False
2012-11-24,6,16639,1,9,10,False
2012-11-24,7,16640,4,21,25,False
2012-11-24,8,16641,7,55,62,False
2012-11-24,9,16642,26,96,122,False
2012-11-24,10,16643,46,96,142,False
2012-11-24,11,16644,55,131,186,False
2012-11-24,12,16645,53,146,199,False
2012-11-24,13,16646,64,161,225,False
2012-11-24,14,16647,58,149,207,False
2012-11-24,15,16648,59,139,198,False
2012-11-24,16,16649,43,127,170,False
2012-11-24,17,16650,29,97,126,False
2012-11-24,18,16651,22,123,145,False
2012-11-24,19,16652,9,74,83,False
2012-11-24,20,16653,3,55,58,False
2012-11-24,21,16654,9,66,75,False
2012-11-24,22,16655,7,69,76,False
2012-11-24,23,16656,9,48,57,False
2012-11-25,0,16657,3,31,34,False
2012-11-25,1,16658,4,32,36,False
2012-11-25,2,16659,1,27,28,False
2012-11-25,3,16660,0,8,8,False
2012-11-25,4,16661,1,1,2,False
2012-11-25,5,16662,0,3,3,False
2012-11-25,6,16663,1,10,11,False
2012-11-25,7,16664,2,19,21,False
2012-11-25,8,16665,2,32,34,False
2012-11-25,9,16666,13,83,96,False
2012-11-25,10,16667,15,124,139,False
2012-11-25,11,16668,49,155,204,False
2012-11-25,12,16669,37,165,202,False
2012-11-25,13,16670,37,158,195,False
2012-11-25,14,16671,33,170,203,False
2012-11-25,15,16672,36,209,245,False
2012-11-25,16,16673,25,203,228,False
2012-11-25,17,16674,11,170,181,False
2012-11-25,18,16675,9,132,141,False
2012-11-25,19,16676,13,114,127,False
2012-11-25,20,16677,9,110,119,False
2012-11-25,21,16678,4,60,64,False
2012-11-25,22,16679,3,59,62,False
2012-11-25,23,16680,1,40,41,False
2012-11-26,0,16681,4,19,23,False
2012-11-26,1,16682,1,9,10,False
2012-11-26,2,16683,0,5,5,False
2012-11-26,3,16684,1,4,5,False
2012-11-26,4,16685,0,10,10,False
2012-11-26,5,16686,0,41,41,False
2012-11-26,6,16687,1,123,124,False
2012-11-26,7,16688,2,363,365,False
2012-11-26,8,16689,9,629,638,False
2012-11-26,9,16690,10,276,286,False
2012-11-26,10,16691,20,127,147,False
2012-11-26,11,16692,18,112,130,False
2012-11-26,12,16693,22,188,210,False
2012-11-26,13,16694,20,197,217,False
2012-11-26,14,16695,51,177,228,False
2012-11-26,15,16696,49,181,230,False
2012-11-26,16,16697,49,297,346,False
2012-11-26,17,16698,13,540,553,False
2012-11-26,18,16699,19,502,521,False
2012-11-26,19,16700,16,355,371,False
2012-11-26,20,16701,12,265,277,False
2012-11-26,21,16702,9,172,181,False
2012-11-26,22,16703,3,101,104,False
2012-11-26,23,16704,8,57,65,False
2012-11-27,0,16705,2,24,26,False
2012-11-27,1,16706,0,6,6,False
2012-11-27,2,16707,0,5,5,False
2012-11-27,3,16708,1,3,4,False
2012-11-27,4,16709,0,5,5,False
2012-11-27,5,16710,0,31,31,False
2012-11-27,6,16711,3,97,100,False
2012-11-27,7,16712,4,289,293,False
2012-11-27,8,16713,6,494,500,False
2012-11-27,9,16714,11,257,268,False
2012-11-27,10,16715,5,52,57,False
2012-11-27,11,16716,6,59,65,False
2012-11-27,12,16717,6,70,76,False
2012-11-27,13,16718,4,73,77,False
2012-11-27,14,16719,8,86,94,False
2012-11-27,15,16720,9,146,155,False
2012-11-27,16,16721,5,252,257,False
2012-11-27,17,16722,13,514,527,False
2012-11-27,18,16723,13,469,482,False
2012-11-27,19,16724,12,338,350,False
2012-11-27,20,16725,4,228,232,False
2012-11-27,21,16726,6,179,185,False
2012-11-27,22,16727,2,95,97,False
2012-11-27,23,16728,3,64,67,False
2012-11-28,0,16729,1,22,23,False
2012-11-28,1,16730,0,12,12,False
2012-11-28,2,16731,0,1,1,False
2012-11-28,3,16732,0,3,3,False
2012-11-28,4,16733,0,4,4,False
2012-11-28,5,16734,0,39,39,False
2012-11-28,6,16735,4,132,136,False
2012-11-28,7,16736,6,403,409,False
2012-11-28,8,16737,9,683,692,False
2012-11-28,9,16738,13,309,322,False
2012-11-28,10,16739,17,144,161,False
2012-11-28,11,16740,19,127,146,False
2012-11-28,12,16741,19,189,208,False
2012-11-28,13,16742,21,193,214,False
2012-11-28,14,16743,15,161,176,False
2012-11-28,15,16744,7,172,179,False
2012-11-28,16,16745,9,316,325,False
2012-11-28,17,16746,17,546,563,False
2012-11-28,18,16747,12,530,542,False
2012-11-28,19,16748,9,378,387,False
2012-11-28,20,16749,5,258,263,False
2012-11-28,21,16750,4,219,223,False
2012-11-28,22,16751,6,148,154,False
2012-11-28,23,16752,5,73,78,False
2012-11-29,0,16753,4,25,29,False
2012-11-29,1,16754,1,15,16,False
2012-11-29,2,16755,1,6,7,False
2012-11-29,3,16756,3,9,12,True
2012-11-29,4,16757,0,7,7,False
2012-11-29,5,16758,0,42,42,False
2012-11-29,6,16759,1,120,121,False
2012-11-29,7,16760,8,354,362,False
2012-11-29,8,16761,15,664,679,False
2012-11-29,9,16762,13,286,299,False
2012-11-29,10,16763,25,153,178,False
2012-11-29,11,16764,13,150,163,False
2012-11-29,12,16765,11,225,236,False
2012-11-29,13,16766,15,209,224,False
2012-11-29,14,16767,13,174,187,False
2012-11-29,15,16768,19,201,220,False
2012-11-29,16,16769,24,346,370,False
2012-11-29,17,16770,17,544,561,False
2012-11-29,18,16771,17,520,537,False
2012-11-29,19,16772,18,326,344,False
2012-11-29,20,16773,11,241,252,False
2012-11-29,21,16774,7,201,208,False
2012-11-29,22,16775,4,147,151,False
2012-11-29,23,16776,6,124,130,False
2012-11-30,0,16777,4,48,52,False
2012-11-30,1,16778,2,17,19,False
2012-11-30,2,16779,2,10,12,False
2012-11-30,3,16780,0,4,4,False
2012-11-30,4,16781,0,3,3,False
2012-11-30,5,16782,1,39,40,False
2012-11-30,6,16783,2,104,106,False
2012-11-30,7,16784,6,346,352,False
2012-11-30,8,16785,20,709,729,False
2012-11-30,9,16786,17,313,330,False
2012-11-30,10,16787,10,159,169,False
2012-11-30,11,16788,31,170,201,False
2012-11-30,12,16789,25,243,268,False
2012-11-30,13,16790,21,241,262,False
2012-11-30,14,16791,26,225,251,False
2012-11-30,15,16792,34,262,296,False
2012-11-30,16,16793,37,368,405,False
2012-11-30,17,16794,31,551,582,False
2012-11-30,18,16795,20,489,509,False
2012-11-30,19,16796,18,359,377,False
2012-11-30,20,16797,12,233,245,False
2012-11-30,21,16798,14,169,183,False
2012-11-30,22,16799,18,145,163,False
2012-11-30,23,16800,11,99,110,False
2012-12-01,0,16801,9,99,108,False
2012-12-01,1,16802,5,64,69,False
2012-12-01,2,16803,3,47,50,False
2012-12-01,3,16804,1,14,15,False
2012-12-01,4,16805,0,5,5,False
2012-12-01,5,16806,1,12,13,False
2012-12-01,6,16807,7,20,27,False
2012-12-01,7,16808,7,56,63,False
2012-12-01,8,16809,11,133,144,False
2012-12-01,9,16810,34,159,193,False
2012-12-01,10,16811,45,211,256,False
2012-12-01,11,16812,74,318,392,False
2012-12-01,12,16813,119,327,446,False
2012-12-01,13,16814,123,386,509,False
2012-12-01,14,16815,110,369,479,False
2012-12-01,15,16816,113,371,484,False
2012-12-01,16,16817,89,354,443,False
2012-12-01,17,16818,50,270,320,False
2012-12-01,18,16819,42,255,297,False
2012-12-01,19,16820,30,219,249,False
2012-12-01,20,16821,28,170,198,False
2012-12-01,21,16822,23,135,158,False
2012-12-01,22,16823,17,130,147,False
2012-12-01,23,16824,10,116,126,False
2012-12-02,0,16825,9,108,117,False
2012-12-02,1,16826,10,84,94,False
2012-12-02,2,16827,2,72,74,False
2012-12-02,3,16828,4,21,25,False
2012-12-02,4,16829,1,6,7,False
2012-12-02,5,16830,1,7,8,False
2012-12-02,6,16831,1,15,16,False
2012-12-02,7,16832,5,26,31,False
2012-12-02,8,16833,12,81,93,False
2012-12-02,9,16834,37,135,172,False
2012-12-02,10,16835,63,230,293,False
2012-12-02,11,16836,81,274,355,False
2012-12-02,12,16837,111,409,520,False
2012-12-02,13,16838,84,347,431,False
2012-12-02,14,16839,142,331,473,False
2012-12-02,15,16840,106,311,417,False
2012-12-02,16,16841,85,358,443,False
2012-12-02,17,16842,59,244,303,False
2012-12-02,18,16843,25,178,203,False
2012-12-02,19,16844,16,158,174,False
2012-12-02,20,16845,12,142,154,False
2012-12-02,21,16846,8,91,99,False
2012-12-02,22,16847,11,85,96,False
2012-12-02,23,16848,7,44,51,False
2012-12-03,0,16849,3,18,21,False
2012-12-03,1,16850,2,11,13,False
2012-12-03,2,16851,1,9,10,False
2012-12-03,3,16852,2,6,8,False
2012-12-03,4,16853,1,4,5,False
2012-12-03,5,16854,0,38,38,False
2012-12-03,6,16855,2,136,138,False
2012-12-03,7,16856,9,387,396,False
2012-12-03,8,16857,19,712,731,False
2012-12-03,9,16858,19,289,308,False
2012-12-03,10,16859,31,105,136,False
2012-12-03,11,16860,51,182,233,False
2012-12-03,12,16861,40,228,268,False
2012-12-03,13,16862,81,240,321,False
2012-12-03,14,16863,51,209,260,False
2012-12-03,15,16864,58,210,268,False
2012-12-03,16,16865,45,397,442,False
2012-12-03,17,16866,43,665,708,False
2012-12-03,18,16867,26,666,692,False
2012-12-03,19,16868,27,444,471,False
2012-12-03,20,16869,16,284,300,False
2012-12-03,21,16870,14,207,221,False
2012-12-03,22,16871,5,139,144,False
2012-12-03,23,16872,9,93,102,False
2012-12-04,0,16873,6,49,55,False
2012-12-04,1,16874,3,22,25,False
2012-12-04,2,16875,3,5,8,False
2012-12-04,3,16876,1,3,4,False
2012-12-04,4,16877,0,7,7,False
2012-12-04,5,16878,1,45,46,False
2012-12-04,6,16879,3,150,153,False
2012-12-04,7,16880,7,495,502,False
2012-12-04,8,16881,21,700,721,False
2012-12-04,9,16882,19,317,336,False
2012-12-04,10,16883,26,130,156,False
2012-12-04,11,16884,24,183,207,False
2012-12-04,12,16885,39,273,312,False
2012-12-04,13,16886,39,233,272,False
2012-12-04,14,16887,39,231,270,False
2012-12-04,15,16888,56,244,300,False
2012-12-04,16,16889,44,391,435,False
2012-12-04,17,16890,43,700,743,False
2012-12-04,18,16891,38,693,731,False
2012-12-04,19,16892,46,414,460,False
2012-12-04,20,16893,34,272,306,False
2012-12-04,21,16894,28,252,280,False
2012-12-04,22,16895,26,155,181,False
2012-12-04,23,16896,5,91,96,False
2012-12-05,0,16897,6,31,37,False
2012-12-05,1,16898,0,11,11,False
2012-12-05,2,16899,2,7,9,False
2012-12-05,3,16900,0,7,7,False
2012-12-05,4,16901,1,9,10,False
2012-12-05,5,16902,1,48,49,False
2012-12-05,6,16903,5,119,124,False
2012-12-05,7,16904,9,389,398,False
2012-12-05,8,16905,22,737,759,False
2012-12-05,9,16906,26,362,388,False
2012-12-05,10,16907,14,127,141,False
2012-12-05,11,16908,11,161,172,False
2012-12-05,12,16909,24,208,232,False
2012-12-05,13,16910,14,200,214,False
2012-12-05,14,16911,39,179,218,False
2012-12-05,15,16912,20,265,285,False
2012-12-05,16,16913,23,354,377,False
2012-12-05,17,16914,29,576,605,False
2012-12-05,18,16915,29,580,609,False
2012-12-05,19,16916,14,400,414,False
2012-12-05,20,16917,19,274,293,False
2012-12-05,21,16918,14,184,198,False
2012-12-05,22,16919,4,101,105,False
2012-12-05,23,16920,5,69,74,False
2012-12-06,0,16921,1,43,44,False
2012-12-06,1,16922,0,16,16,False
2012-12-06,2,16923,0,9,9,False
2012-12-06,3,16924,0,2,2,False
2012-12-06,4,16925,1,8,9,False
2012-12-06,5,16926,0,32,32,False
2012-12-06,6,16927,2,122,124,False
2012-12-06,7,16928,8,381,389,False
2012-12-06,8,16929,13,646,659,False
2012-12-06,9,16930,19,257,276,False
2012-12-06,10,16931,23,122,145,False
2012-12-06,11,16932,16,162,178,False
2012-12-06,12,16933,29,206,235,False
2012-12-06,13,16934,33,212,245,False
2012-12-06,14,16935,37,175,212,False
2012-12-06,15,16936,38,232,270,False
2012-12-06,16,16937,39,292,331,False
2012-12-06,17,16938,31,586,617,False
2012-12-06,18,16939,23,542,565,False
2012-12-06,19,16940,13,360,373,False
2012-12-06,20,16941,5,222,227,False
2012-12-06,21,16942,7,184,191,False
2012-12-06,22,16943,2,131,133,False
2012-12-06,23,16944,0,93,93,False
2012-12-07,0,16945,3,45,48,False
2012-12-07,1,16946,2,26,28,False
2012-12-07,2,16947,0,11,11,False
2012-12-07,3,16948,0,5,5,False
2012-12-07,4,16949,0,10,10,False
2012-12-07,5,16950,1,25,26,False
2012-12-07,6,16951,0,84,84,False
2012-12-07,7,16952,3,212,215,False
2012-12-07,8,16953,11,430,441,False
2012-12-07,9,16954,10,291,301,False
2012-12-07,10,16955,16,150,166,False
2012-12-07,11,16956,20,183,203,False
2012-12-07,12,16957,36,204,240,False
2012-12-07,13,16958,23,197,220,False
2012-12-07,14,16959,40,175,215,False
2012-12-07,15,16960,34,269,303,False
2012-12-07,16,16961,39,336,375,False
2012-12-07,17,16962,29,539,568,False
2012-12-07,18,16963,25,473,498,False
2012-12-07,19,16964,15,337,352,False
2012-12-07,20,16965,12,229,241,False
2012-12-07,21,16966,9,162,171,False
2012-12-07,22,16967,15,150,165,False
2012-12-07,23,16968,6,116,122,False
2012-12-08,0,16969,5,98,103,False
2012-12-08,1,16970,16,84,100,False
2012-12-08,2,16971,3,67,70,False
2012-12-08,3,16972,6,23,29,False
2012-12-08,4,16973,3,9,12,False
2012-12-08,5,16974,2,4,6,False
2012-12-08,6,16975,1,19,20,False
2012-12-08,7,16976,3,36,39,False
2012-12-08,8,16977,5,106,111,False
2012-12-08,9,16978,17,153,170,False
2012-12-08,10,16979,43,244,287,False
2012-12-08,11,16980,63,341,404,False
2012-12-08,12,16981,122,364,486,False
2012-12-08,13,16982,148,399,547,False
2012-12-08,14,16983,164,378,542,False
2012-12-08,15,16984,167,374,541,False
2012-12-08,16,16985,139,368,507,False
2012-12-08,17,16986,77,268,345,False
2012-12-08,18,16987,40,264,304,False
2012-12-08,19,16988,34,212,246,False
2012-12-08,20,16989,20,162,182,False
2012-12-08,21,16990,34,175,209,False
2012-12-08,22,16991,23,137,160,False
2012-12-08,23,16992,18,144,162,False
2012-12-09,0,16993,15,103,118,False
2012-12-09,1,16994,17,85,102,False
2012-12-09,2,16995,8,70,78,False
2012-12-09,3,16996,14,34,48,False
2012-12-09,4,16997,1,11,12,False
2012-12-09,5,16998,0,8,8,False
2012-12-09,6,16999,0,6,6,False
2012-12-09,7,17000,1,22,23,False
2012-12-09,8,17001,1,68,69,False
2012-12-09,9,17002,9,94,103,False
2012-12-09,10,17003,39,180,219,False
2012-12-09,11,17004,40,210,250,False
2012-12-09,12,17005,60,255,315,False
2012-12-09,13,17006,65,220,285,False
2012-12-09,14,17007,42,190,232,False
2012-12-09,15,17008,25,200,225,False
2012-12-09,16,17009,33,220,253,False
2012-12-09,17,17010,20,209,229,False
2012-12-09,18,17011,17,181,198,False
2012-12-09,19,17012,12,110,122,False
2012-12-09,20,17013,6,102,108,False
2012-12-09,21,17014,10,86,96,False
2012-12-09,22,17015,3,75,78,False
2012-12-09,23,17016,3,48,51,False
2012-12-10,0,17017,0,20,20,False
2012-12-10,1,17018,0,4,4,False
2012-12-10,2,17019,2,3,5,False
2012-12-10,3,17020,0,4,4,False
2012-12-10,4,17021,3,9,12,False
2012-12-10,5,17022,0,27,27,False
2012-12-10,6,17023,2,121,123,False
2012-12-10,7,17024,3,291,294,False
2012-12-10,8,17025,9,575,584,False
2012-12-10,9,17026,11,273,284,False
2012-12-10,10,17027,12,121,133,False
2012-12-10,11,17028,8,126,134,False
2012-12-10,12,17029,23,150,173,False
2012-12-10,13,17030,30,190,220,False
2012-12-10,14,17031,31,179,210,False
2012-12-10,15,17032,29,207,236,False
2012-12-10,16,17033,37,308,345,False
2012-12-10,17,17034,38,578,616,False
2012-12-10,18,17035,20,544,564,False
2012-12-10,19,17036,18,409,427,False
2012-12-10,20,17037,13,287,300,False
2012-12-10,21,17038,21,224,245,False
2012-12-10,22,17039,11,115,126,False
2012-12-10,23,17040,8,76,84,False
2012-12-11,0,17041,2,29,31,False
2012-12-11,1,17042,1,7,8,False
2012-12-11,2,17043,0,1,1,False
2012-12-11,3,17044,0,3,3,False
2012-12-11,4,17045,0,8,8,False
2012-12-11,5,17046,1,40,41,False
2012-12-11,6,17047,0,118,118,False
2012-12-11,7,17048,8,372,380,False
2012-12-11,8,17049,16,708,724,False
2012-12-11,9,17050,12,322,334,False
2012-12-11,10,17051,12,142,154,False
2012-12-11,11,17052,28,145,173,False
2012-12-11,12,17053,13,213,226,False
2012-12-11,13,17054,28,226,254,False
2012-12-11,14,17055,19,185,204,False
2012-12-11,15,17056,20,250,270,False
2012-12-11,16,17057,24,334,358,False
2012-12-11,17,17058,21,580,601,False
2012-12-11,18,17059,23,523,546,False
2012-12-11,19,17060,21,412,433,False
2012-12-11,20,17061,9,248,257,False
2012-12-11,21,17062,14,193,207,False
2012-12-11,22,17063,6,100,106,False
2012-12-11,23,17064,4,60,64,False
2012-12-12,0,17065,1,33,34,False
2012-12-12,1,17066,3,18,21,False
2012-12-12,2,17067,5,4,9,False
2012-12-12,3,17068,3,7,10,False
2012-12-12,4,17069,0,4,4,False
2012-12-12,5,17070,0,37,37,False
2012-12-12,6,17071,2,126,128,False
2012-12-12,7,17072,3,366,369,False
2012-12-12,8,17073,18,670,688,False
2012-12-12,9,17074,13,272,285,False
2012-12-12,10,17075,20,116,136,False
2012-12-12,11,17076,24,148,172,False
2012-12-12,12,17077,14,218,232,False
2012-12-12,13,17078,18,220,238,False
2012-12-12,14,17079,34,191,225,False
2012-12-12,15,17080,21,207,228,False
2012-12-12,16,17081,19,310,329,False
2012-12-12,17,17082,21,540,561,False
2012-12-12,18,17083,25,515,540,False
2012-12-12,19,17084,18,384,402,False
2012-12-12,20,17085,25,243,268,False
2012-12-12,21,17086,16,186,202,False
2012-12-12,22,17087,4,118,122,False
2012-12-12,23,17088,3,76,79,False
2012-12-13,0,17089,1,31,32,False
2012-12-13,1,17090,4,19,23,False
2012-12-13,2,17091,3,5,8,False
2012-12-13,3,17092,0,2,2,False
2012-12-13,4,17093,0,8,8,False
2012-12-13,5,17094,2,31,33,False
2012-12-13,6,17095,2,112,114,False
2012-12-13,7,17096,5,380,385,False
2012-12-13,8,17097,24,655,679,False
2012-12-13,9,17098,25,300,325,False
2012-12-13,10,17099,28,139,167,False
2012-12-13,11,17100,25,164,189,False
2012-12-13,12,17101,30,252,282,False
2012-12-13,13,17102,41,230,271,False
2012-12-13,14,17103,31,211,242,False
2012-12-13,15,17104,40,240,280,False
2012-12-13,16,17105,50,356,406,False
2012-12-13,17,17106,43,507,550,False
2012-12-13,18,17107,20,446,466,False
2012-12-13,19,17108,20,328,348,False
2012-12-13,20,17109,6,235,241,False
2012-12-13,21,17110,13,200,213,False
2012-12-13,22,17111,7,141,148,False
2012-12-13,23,17112,5,115,120,False
2012-12-14,0,17113,4,43,47,False
2012-12-14,1,17114,0,26,26,False
2012-12-14,2,17115,3,6,9,False
2012-12-14,3,17116,0,12,12,False
2012-12-14,4,17117,1,9,10,False
2012-12-14,5,17118,0,34,34,False
2012-12-14,6,17119,1,112,113,False
2012-12-14,7,17120,3,305,308,False
2012-12-14,8,17121,13,623,636,False
2012-12-14,9,17122,13,330,343,False
2012-12-14,10,17123,28,162,190,False
2012-12-14,11,17124,31,180,211,False
2012-12-14,12,17125,29,244,273,False
2012-12-14,13,17126,39,274,313,False
2012-12-14,14,17127,48,251,299,False
2012-12-14,15,17128,57,252,309,False
2012-12-14,16,17129,45,372,417,False
2012-12-14,17,17130,40,582,622,False
2012-12-14,18,17131,23,432,455,False
2012-12-14,19,17132,17,302,319,False
2012-12-14,20,17133,12,209,221,False
2012-12-14,21,17134,7,165,172,False
2012-12-14,22,17135,4,134,138,False
2012-12-14,23,17136,11,123,134,False
2012-12-15,0,17137,4,90,94,False
2012-12-15,1,17138,9,86,95,False
2012-12-15,2,17139,6,63,69,False
2012-12-15,3,17140,5,18,23,False
2012-12-15,4,17141,1,5,6,False
2012-12-15,5,17142,0,3,3,False
2012-12-15,6,17143,0,11,11,False
2012-12-15,7,17144,1,47,48,False
2012-12-15,8,17145,8,111,119,False
2012-12-15,9,17146,17,203,220,False
2012-12-15,10,17147,23,250,273,False
2012-12-15,11,17148,66,327,393,False
2012-12-15,12,17149,89,364,453,False
2012-12-15,13,17150,88,368,456,False
2012-12-15,14,17151,92,334,426,False
2012-12-15,15,17152,95,352,447,False
2012-12-15,16,17153,85,328,413,False
2012-12-15,17,17154,35,274,309,False
2012-12-15,18,17155,40,232,272,False
2012-12-15,19,17156,32,225,257,False
2012-12-15,20,17157,23,178,201,False
2012-12-15,21,17158,15,169,184,False
2012-12-15,22,17159,22,134,156,False
2012-12-15,23,17160,11,108,119,False
2012-12-16,0,17161,8,102,110,False
2012-12-16,1,17162,14,82,96,False
2012-12-16,2,17163,8,79,87,False
2012-12-16,3,17164,1,37,38,False
2012-12-16,4,17165,1,10,11,False
2012-12-16,5,17166,0,9,9,False
2012-12-16,6,17167,0,6,6,False
2012-12-16,7,17168,5,22,27,False
2012-12-16,8,17169,12,76,88,False
2012-12-16,9,17170,19,113,132,False
2012-12-16,10,17171,42,215,257,False
2012-12-16,11,17172,47,248,295,False
2012-12-16,12,17173,67,350,417,False
2012-12-16,13,17174,67,289,356,False
2012-12-16,14,17175,50,260,310,False
2012-12-16,15,17176,46,292,338,False
2012-12-16,16,17177,66,334,400,False
2012-12-16,17,17178,29,214,243,False
2012-12-16,18,17179,8,99,107,False
2012-12-16,19,17180,10,99,109,False
2012-12-16,20,17181,14,108,122,False
2012-12-16,21,17182,14,92,106,False
2012-12-16,22,17183,6,83,89,False
2012-12-16,23,17184,4,29,33,False
2012-12-17,0,17185,2,26,28,False
2012-12-17,1,17186,1,14,15,False
2012-12-17,2,17187,1,4,5,False
2012-12-17,3,17188,0,3,3,False
2012-12-17,4,17189,2,3,5,False
2012-12-17,5,17190,0,24,24,False
2012-12-17,6,17191,1,107,108,False
2012-12-17,7,17192,5,314,319,False
2012-12-17,8,17193,10,582,592,False
2012-12-17,9,17194,11,271,282,False
2012-12-17,10,17195,15,120,135,False
2012-12-17,11,17196,22,148,170,False
2012-12-17,12,17197,21,211,232,False
2012-12-17,13,17198,16,194,210,False
2012-12-17,14,17199,12,169,181,False
2012-12-17,15,17200,15,196,211,False
2012-12-17,16,17201,15,287,302,False
2012-12-17,17,17202,17,478,495,False
2012-12-17,18,17203,14,493,507,False
2012-12-17,19,17204,7,333,340,False
2012-12-17,20,17205,8,192,200,False
2012-12-17,21,17206,6,114,120,False
2012-12-17,22,17207,5,49,54,False
2012-12-17,23,17208,6,41,47,False
2012-12-18,0,17209,0,18,18,False
2012-12-18,1,17210,0,15,15,False
2012-12-18,2,17211,2,5,7,False
2012-12-18,3,17212,0,5,5,False
2012-12-18,4,17213,3,5,8,False
2012-12-18,5,17214,0,36,36,False
2012-12-18,6,17215,1,117,118,False
2012-12-18,7,17216,4,351,355,False
2012-12-18,8,17217,10,652,662,False
2012-12-18,9,17218,19,307,326,False
2012-12-18,10,17219,22,162,184,False
2012-12-18,11,17220,58,211,269,False
2012-12-18,12,17221,49,264,313,False
2012-12-18,13,17222,51,235,286,False
2012-12-18,14,17223,56,191,247,False
2012-12-18,15,17224,28,218,246,False
2012-12-18,16,17225,40,323,363,False
2012-12-18,17,17226,39,533,572,False
2012-12-18,18,17227,13,512,525,False
2012-12-18,19,17228,19,334,353,False
2012-12-18,20,17229,4,264,268,False
2012-12-18,21,17230,9,159,168,False
2012-12-18,22,17231,5,127,132,False
2012-12-18,23,17232,1,80,81,False
2012-12-19,0,17233,6,35,41,False
2012-12-19,1,17234,1,14,15,False
2012-12-19,2,17235,1,2,3,False
2012-12-19,3,17236,0,5,5,False
2012-12-19,4,17237,1,6,7,False
2012-12-19,5,17238,2,29,31,False
2012-12-19,6,17239,3,109,112,False
2012-12-19,7,17240,3,360,363,False
2012-12-19,8,17241,13,665,678,False
2012-12-19,9,17242,8,309,317,False
2012-12-19,10,17243,17,147,164,False
2012-12-19,11,17244,31,169,200,False
2012-12-19,12,17245,33,203,236,False
2012-12-19,13,17246,30,183,213,False
2012-12-19,14,17247,33,185,218,False
2012-12-19,15,17248,28,209,237,False
2012-12-19,16,17249,37,297,334,False
2012-12-19,17,17250,26,536,562,False
2012-12-19,18,17251,23,546,569,False
2012-12-19,19,17252,7,329,336,False
2012-12-19,20,17253,10,231,241,False
2012-12-19,21,17254,4,164,168,False
2012-12-19,22,17255,12,117,129,False
2012-12-19,23,17256,4,84,88,False
2012-12-20,0,17257,2,40,42,False
2012-12-20,1,17258,1,19,20,False
2012-12-20,2,17259,2,6,8,False
2012-12-20,3,17260,1,3,4,False
2012-12-20,4,17261,0,6,6,False
2012-12-20,5,17262,0,35,35,False
2012-12-20,6,17263,4,114,118,False
2012-12-20,7,17264,4,346,350,False
2012-12-20,8,17265,14,585,599,False
2012-12-20,9,17266,14,303,317,False
2012-12-20,10,17267,23,138,161,False
2012-12-20,11,17268,22,168,190,False
2012-12-20,12,17269,31,181,212,False
2012-12-20,13,17270,46,171,217,False
2012-12-20,14,17271,43,171,214,False
2012-12-20,15,17272,33,216,249,False
2012-12-20,16,17273,21,281,302,False
2012-12-20,17,17274,25,450,475,False
2012-12-20,18,17275,22,359,381,False
2012-12-20,19,17276,3,115,118,False
2012-12-20,20,17277,1,49,50,False
2012-12-20,21,17278,1,25,26,False
2012-12-20,22,17279,1,20,21,False
2012-12-20,23,17280,0,13,13,False
2012-12-21,0,17281,0,17,17,False
2012-12-21,1,17282,2,7,9,False
2012-12-21,2,17283,0,3,3,False
2012-12-21,3,17284,0,3,3,False
2012-12-21,4,17285,1,5,6,False
2012-12-21,5,17286,0,13,13,False
2012-12-21,6,17287,4,76,80,False
2012-12-21,7,17288,3,205,208,False
2012-12-21,8,17289,8,464,472,False
2012-12-21,9,17290,2,265,267,False
2012-12-21,10,17291,8,146,154,False
2012-12-21,11,17292,12,150,162,False
2012-12-21,12,17293,25,199,224,False
2012-12-21,13,17294,26,214,240,False
2012-12-21,14,17295,20,199,219,False
2012-12-21,15,17296,29,234,263,False
2012-12-21,16,17297,28,253,281,False
2012-12-21,17,17298,24,297,321,False
2012-12-21,18,17299,7,236,243,False
2012-12-21,19,17300,5,148,153,False
2012-12-21,20,17301,8,104,112,False
2012-12-21,21,17302,2,68,70,False
2012-12-21,22,17303,6,57,63,False
2012-12-21,23,17304,1,39,40,False
2012-12-22,0,17305,1,30,31,False
2012-12-22,1,17306,1,34,35,False
2012-12-22,2,17307,0,23,23,False
2012-12-22,3,17308,0,7,7,False
2012-12-22,4,17309,3,2,5,False
2012-12-22,5,17310,0,5,5,False
2012-12-22,6,17311,0,13,13,False
2012-12-22,7,17312,2,18,20,False
2012-12-22,8,17313,0,29,29,False
2012-12-22,9,17314,13,77,90,False
2012-12-22,10,17315,13,105,118,False
2012-12-22,11,17316,29,130,159,False
2012-12-22,12,17317,18,128,146,False
2012-12-22,13,17318,23,135,158,False
2012-12-22,14,17319,20,141,161,False
2012-12-22,15,17320,14,139,153,False
2012-12-22,16,17321,23,124,147,False
2012-12-22,17,17322,15,99,114,False
2012-12-22,18,17323,7,75,82,False
2012-12-22,19,17324,9,51,60,False
2012-12-22,20,17325,6,55,61,False
2012-12-22,21,17326,4,49,53,False
2012-12-22,22,17327,1,38,39,False
2012-12-22,23,17328,3,37,40,False
2012-12-23,0,17329,3,24,27,False
2012-12-23,1,17330,1,19,20,False
2012-12-23,2,17331,1,17,18,False
2012-12-23,3,17332,0,9,9,False
2012-12-23,4,17333,1,3,4,False
2012-12-23,5,17334,0,6,6,False
2012-12-23,6,17335,4,5,9,False
2012-12-23,7,17336,3,16,19,False
2012-12-23,8,17337,5,43,48,False
2012-12-23,9,17338,7,49,56,False
2012-12-23,10,17339,26,67,93,False
2012-12-23,11,17340,48,104,152,False
2012-12-23,12,17341,52,144,196,False
2012-12-23,13,17342,63,123,186,False
2012-12-23,14,17343,57,118,175,False
2012-12-23,15,17344,39,98,137,False
2012-12-23,16,17345,53,137,190,False
2012-12-23,17,17346,21,93,114,False
2012-12-23,18,17347,8,85,93,False
2012-12-23,19,17348,4,54,58,False
2012-12-23,20,17349,0,52,52,False
2012-12-23,21,17350,4,38,42,False
2012-12-23,22,17351,5,53,58,False
2012-12-23,23,17352,3,22,25,False
2012-12-24,0,17353,0,12,12,False
2012-12-24,1,17354,0,11,11,False
2012-12-24,2,17355,0,5,5,False
2012-12-24,3,17356,1,2,3,False
2012-12-24,4,17357,1,5,6,True
2012-12-24,5,17358,0,9,9,False
2012-12-24,6,17359,1,16,17,False
2012-12-24,7,17360,3,27,30,False
2012-12-24,8,17361,4,62,66,False
2012-12-24,9,17362,17,68,85,False
2012-12-24,10,17363,21,82,103,False
2012-12-24,11,17364,20,104,124,False
2012-12-24,12,17365,22,113,135,False
2012-12-24,13,17366,16,54,70,False
2012-12-24,14,17367,13,33,46,False
2012-12-24,15,17368,6,27,33,False
2012-12-24,16,17369,6,27,33,False
2012-12-24,17,17370,7,19,26,False
2012-12-24,18,17371,6,20,26,False
2012-12-24,19,17372,4,14,18,False
2012-12-24,20,17373,6,17,23,False
2012-12-24,21,17374,13,9,22,False
2012-12-24,22,17375,7,5,12,False
2012-12-24,23,17376,1,10,11,False
2012-12-25,0,17377,3,10,13,False
2012-12-25,1,17378,0,13,13,False
2012-12-25,2,17379,0,7,7,False
2012-12-25,3,17380,3,9,12,True
2012-12-25,4,17381,0,1,1,False
2012-12-25,5,17382,2,1,3,False
2012-12-25,6,17383,1,6,7,False
2012-12-25,7,17384,0,6,6,False
2012-12-25,8,17385,1,10,11,False
2012-12-25,9,17386,7,21,28,False
2012-12-25,10,17387,11,21,32,False
2012-12-25,11,17388,43,43,86,False
2012-12-25,12,17389,62,52,114,False
2012-12-25,13,17390,75,46,121,False
2012-12-25,14,17391,58,68,126,False
2012-12-25,15,17392,51,56,107,False
2012-12-25,16,17393,48,38,86,False
2012-12-25,17,17394,16,34,50,False
2012-12-25,18,17395,20,23,43,False
2012-12-25,19,17396,16,20,36,False
2012-12-25,20,17397,11,29,40,False
2012-12-25,21,17398,8,26,34,False
2012-12-25,22,17399,3,16,19,False
2012-12-25,23,17400,4,26,30,False
2012-12-26,0,17401,1,8,9,False
2012-12-26,1,17402,0,7,7,False
2012-12-26,2,17403,0,1,1,False
2012-12-26,3,17404,0,2,2,False
2012-12-26,4,17405,0,2,2,False
2012-12-26,5,17406,0,11,11,False
2012-12-26,6,17407,0,36,36,False
2012-12-26,7,17408,0,26,26,False
2012-12-26,8,17409,0,31,31,False
2012-12-26,9,17410,1,22,23,False
2012-12-26,10,17411,0,8,8,False
2012-12-26,11,17412,0,10,10,False
2012-12-26,12,17413,0,10,10,False
2012-12-26,13,17414,0,15,15,False
2012-12-26,14,17415,0,20,20,False
2012-12-26,15,17416,0,13,13,False
2012-12-26,16,17417,0,13,13,False
2012-12-26,17,17418,2,51,53,False
2012-12-26,18,17419,1,42,43,False
2012-12-26,19,17420,2,33,35,False
2012-12-26,20,17421,0,32,32,False
2012-12-26,21,17422,0,20,20,False
2012-12-26,22,17423,0,11,11,False
2012-12-26,23,17424,2,8,10,False
2012-12-27,0,17425,0,3,3,False
2012-12-27,1,17426,0,5,5,False
2012-12-27,2,17427,0,2,2,False
2012-12-27,3,17428,0,1,1,False
2012-12-27,4,17429,0,3,3,False
2012-12-27,5,17430,1,10,11,False
2012-12-27,6,17431,0,45,45,False
2012-12-27,7,17432,0,90,90,False
2012-12-27,8,17433,2,206,208,False
2012-12-27,9,17434,6,127,133,False
2012-12-27,10,17435,8,67,75,False
2012-12-27,11,17436,23,80,103,False
2012-12-27,12,17437,22,87,109,False
2012-12-27,13,17438,19,99,118,False
2012-12-27,14,17439,25,94,119,False
2012-12-27,15,17440,31,89,120,False
2012-12-27,16,17441,23,151,174,False
2012-12-27,17,17442,30,227,257,False
2012-12-27,18,17443,9,188,197,False
2012-12-27,19,17444,11,106,117,False
2012-12-27,20,17445,12,79,91,False
2012-12-27,21,17446,12,51,63,False
2012-12-27,22,17447,11,33,44,False
2012-12-27,23,17448,2,24,26,False
2012-12-28,0,17449,3,22,25,False
2012-12-28,1,17450,0,9,9,False
2012-12-28,2,17451,0,5,5,False
2012-12-28,3,17452,0,2,2,False
2012-12-28,4,17453,0,4,4,False
2012-12-28,5,17454,0,15,15,False
2012-12-28,6,17455,2,49,51,False
2012-12-28,7,17456,1,111,112,False
2012-12-28,8,17457,1,238,239,False
2012-12-28,9,17458,18,173,191,False
2012-12-28,10,17459,77,85,162,False
2012-12-28,11,17460,71,107,178,False
2012-12-28,12,17461,72,150,222,False
2012-12-28,13,17462,76,146,222,False
2012-12-28,14,17463,84,177,261,False
2012-12-28,15,17464,74,151,225,False
2012-12-28,16,17465,42,208,250,False
2012-12-28,17,17466,43,228,271,False
2012-12-28,18,17467,16,197,213,False
2012-12-28,19,17468,15,113,128,False
2012-12-28,20,17469,14,83,97,False
2012-12-28,21,17470,17,75,92,False
2012-12-28,22,17471,13,49,62,False
2012-12-28,23,17472,5,54,59,False
2012-12-29,0,17473,1,25,26,False
2012-12-29,1,17474,6,31,37,False
2012-12-29,2,17475,1,18,19,False
2012-12-29,3,17476,1,5,6,False
2012-12-29,4,17477,0,3,3,False
2012-12-29,5,17478,0,3,3,False
2012-12-29,6,17479,0,7,7,False
2012-12-29,7,17480,1,17,18,False
2012-12-29,8,17481,9,35,44,False
2012-12-29,9,17482,16,33,49,False
2012-12-29,10,17483,6,35,41,False
2012-12-29,11,17484,7,38,45,False
2012-12-29,12,17485,5,43,48,False
2012-12-29,13,17486,13,71,84,False
2012-12-29,14,17487,10,88,98,False
2012-12-29,15,17488,19,110,129,False
2012-12-29,16,17489,22,125,147,False
2012-12-29,17,17490,18,100,118,False
2012-12-29,18,17491,8,102,110,False
2012-12-29,19,17492,7,90,97,False
2012-12-29,20,17493,2,64,66,False
2012-12-29,21,17494,4,56,60,False
2012-12-29,22,17495,3,51,54,False
2012-12-29,23,17496,0,32,32,False
2012-12-30,0,17497,0,41,41,False
2012-12-30,1,17498,1,27,28,False
2012-12-30,2,17499,0,19,19,False
2012-12-30,3,17500,1,14,15,False
2012-12-30,4,17501,0,7,7,False
2012-12-30,5,17502,0,2,2,False
2012-12-30,6,17503,1,7,8,False
2012-12-30,7,17504,0,13,13,False
2012-12-30,8,17505,1,32,33,False
2012-12-30,9,17506,9,65,74,False
2012-12-30,10,17507,31,91,122,False
2012-12-30,11,17508,33,103,136,False
2012-12-30,12,17509,47,97,144,False
2012-12-30,13,17510,49,120,169,False
2012-12-30,14,17511,39,121,160,False
2012-12-30,15,17512,37,101,138,False
2012-12-30,16,17513,31,102,133,False
2012-12-30,17,17514,26,97,123,False
2012-12-30,18,17515,12,113,125,False
2012-12-30,19,17516,16,86,102,False
2012-12-30,20,17517,9,63,72,False
2012-12-30,21,17518,5,42,47,False
2012-12-30,22,17519,6,30,36,False
2012-12-30,23,17520,10,39,49,False
2012-12-31,0,17521,4,30,34,False
2012-12-31,1,17522,6,13,19,False
2012-12-31,2,17523,3,8,11,False
2012-12-31,3,17524,0,1,1,False
2012-12-31,4,17525,0,3,3,False
2012-12-31,5,17526,0,9,9,False
2012-12-31,6,17527,0,40,40,False
2012-12-31,7,17528,2,83,85,False
2012-12-31,8,17529,9,187,196,False
2012-12-31,9,17530,13,144,157,False
2012-12-31,10,17531,33,87,120,False
2012-12-31,11,17532,43,114,157,False
2012-12-31,12,17533,52,172,224,False
2012-12-31,13,17534,38,165,203,False
2012-12-31,14,17535,62,185,247,False
2012-12-31,15,17536,69,246,315,False
2012-12-31,16,17537,30,184,214,False
2012-12-31,17,17538,14,150,164,False
2012-12-31,18,17539,10,112,122,False
2012-12-31,19,17540,11,108,119,False
2012-12-31,20,17541,8,81,89,False
2012-12-31,21,17542,7,83,90,False
2012-12-31,22,17543,13,48,61,False
2012-12-31,23,17544,12,37,49,False
